id,NumOfCur,NumOfIncur,PerOfCur,PerOfIncur,NumOfVotes
1002496,4,0,1.000000,0.000000,4
1001480,8,8,0.500000,0.500000,16
1001491,1,0,1.000000,0.000000,1
1002160,36,17,0.679245,0.320755,53
1002161,26,7,0.787879,0.212121,33
1001516,3,3,0.500000,0.500000,6
1002341,2,10,0.166667,0.833333,12
1001530,2,1,0.666667,0.333333,3
1002273,3,0,1.000000,0.000000,3
1001538,4,4,0.500000,0.500000,8
1002167,5,2,0.714286,0.285714,7
1001549,10,8,0.555556,0.444444,18
1001554,9,6,0.600000,0.400000,15
1001556,0,2,0.000000,1.000000,2
1001566,2,0,1.000000,0.000000,2
1001567,2,0,1.000000,0.000000,2
1002172,1,0,1.000000,0.000000,1
1002174,0,2,0.000000,1.000000,2
1002859,0,2,0.000000,1.000000,2
1001604,8,2,0.800000,0.200000,10
1001611,3,0,1.000000,0.000000,3
1001612,14,0,1.000000,0.000000,14
1001616,29,11,0.725000,0.275000,40
1002520,2,0,1.000000,0.000000,2
1001619,2,3,0.400000,0.600000,5
1001623,45,21,0.681818,0.318182,66
1002180,4,0,1.000000,0.000000,4
1002182,2,0,1.000000,0.000000,2
1002866,6,0,1.000000,0.000000,6
1001653,8,0,1.000000,0.000000,8
1001656,3,2,0.600000,0.400000,5
1001661,2,0,1.000000,0.000000,2
1001663,2,0,1.000000,0.000000,2
1002528,2,1,0.666667,0.333333,3
1001505,2,1,0.666667,0.333333,3
1001682,68,16,0.809524,0.190476,84
1001690,4,1,0.800000,0.200000,5
1002191,1,0,1.000000,0.000000,1
1001692,3,0,1.000000,0.000000,3
1001697,44,16,0.733333,0.266667,60
1002279,14,6,0.700000,0.300000,20
1001716,1,0,1.000000,0.000000,1
1002576,4,0,1.000000,0.000000,4
1001740,17,13,0.566667,0.433333,30
1002280,6,8,0.428571,0.571429,14
1001746,17,8,0.680000,0.320000,25
1002144,10,12,0.454545,0.545455,22
1001764,9,19,0.321429,0.678571,28
1001768,12,15,0.444444,0.555556,27
1002281,2,0,1.000000,0.000000,2
1002145,2,1,0.666667,0.333333,3
1001796,35,18,0.660377,0.339623,53
1002209,2,0,1.000000,0.000000,2
1001802,2,0,1.000000,0.000000,2
1002211,2,0,1.000000,0.000000,2
1002553,2,0,1.000000,0.000000,2
1002215,4,0,1.000000,0.000000,4
1001836,20,10,0.666667,0.333333,30
1001840,9,4,0.692308,0.307692,13
1001846,51,25,0.671053,0.328947,76
1001854,0,2,0.000000,1.000000,2
1001871,2,0,1.000000,0.000000,2
1001877,3,3,0.500000,0.500000,6
1002223,6,4,0.600000,0.400000,10
1002224,2,1,0.666667,0.333333,3
1002907,2,0,1.000000,0.000000,2
1001892,4,2,0.666667,0.333333,6
1001895,25,18,0.581395,0.418605,43
1001896,2,0,1.000000,0.000000,2
1002909,2,1,0.666667,0.333333,3
1001910,2,1,0.666667,0.333333,3
1001911,7,12,0.368421,0.631579,19
1001912,0,1,0.000000,1.000000,1
1002286,6,0,1.000000,0.000000,6
1002232,46,39,0.541176,0.458824,85
1001942,2,3,0.400000,0.600000,5
1001943,0,1,0.000000,1.000000,1
1001945,2,0,1.000000,0.000000,2
1001946,6,2,0.750000,0.250000,8
1001949,16,25,0.390244,0.609756,41
1001953,43,50,0.462366,0.537634,93
1001962,0,2,0.000000,1.000000,2
1001963,2,0,1.000000,0.000000,2
1001966,7,4,0.636364,0.363636,11
1001971,2,0,1.000000,0.000000,2
1001973,9,0,1.000000,0.000000,9
1001975,49,12,0.803279,0.196721,61
1001980,1,7,0.125000,0.875000,8
1001984,52,41,0.559140,0.440860,93
1001987,4,0,1.000000,0.000000,4
1001991,2,0,1.000000,0.000000,2
1001994,12,4,0.750000,0.250000,16
1002152,64,18,0.780488,0.219512,82
1002000,6,0,1.000000,0.000000,6
1002001,1,0,1.000000,0.000000,1
1002008,2,0,1.000000,0.000000,2
1002009,2,2,0.500000,0.500000,4
1002012,9,0,1.000000,0.000000,9
1002289,79,25,0.759615,0.240385,104
1002221,2,0,1.000000,0.000000,2
1002021,1,0,1.000000,0.000000,1
1002588,3,0,1.000000,0.000000,3
1002040,5,0,1.000000,0.000000,5
1002042,6,0,1.000000,0.000000,6
1002050,8,1,0.888889,0.111111,9
1000006,56,29,0.658824,0.341176,85
1000022,13,9,0.590909,0.409091,22
1000025,9,3,0.750000,0.250000,12
1000028,9,13,0.409091,0.590909,22
1000029,39,42,0.481481,0.518519,81
1000033,20,11,0.645161,0.354839,31
1000034,43,31,0.581081,0.418919,74
1000035,20,7,0.740741,0.259259,27
1002086,3,1,0.750000,0.250000,4
1000040,42,36,0.538462,0.461538,78
1000042,2,0,1.000000,0.000000,2
1000044,7,7,0.500000,0.500000,14
1002095,7,8,0.466667,0.533333,15
1000050,14,7,0.666667,0.333333,21
1000051,4,2,0.666667,0.333333,6
1000052,55,34,0.617978,0.382022,89
1000055,59,46,0.561905,0.438095,105
1000056,2,0,1.000000,0.000000,2
1000057,37,20,0.649123,0.350877,57
1000068,59,43,0.578431,0.421569,102
1002117,5,3,0.625000,0.375000,8
1000071,65,39,0.625000,0.375000,104
1000073,21,16,0.567568,0.432432,37
1000074,33,17,0.660000,0.340000,50
1000076,9,1,0.900000,0.100000,10
1000077,57,56,0.504425,0.495575,113
1000078,16,16,0.500000,0.500000,32
1000079,7,5,0.583333,0.416667,12
1002128,49,14,0.777778,0.222222,63
1000082,40,12,0.769231,0.230769,52
1000086,3,3,0.500000,0.500000,6
1000087,2,1,0.666667,0.333333,3
1002136,2,2,0.500000,0.500000,4
1002137,25,14,0.641026,0.358974,39
1000099,4,0,1.000000,0.000000,4
1002150,23,23,0.500000,0.500000,46
1002151,2,7,0.222222,0.777778,9
1000104,9,6,0.600000,0.400000,15
1000106,4,3,0.571429,0.428571,7
1000111,56,21,0.727273,0.272727,77
1000112,10,3,0.769231,0.230769,13
1000118,54,37,0.593407,0.406593,91
1000122,3,2,0.600000,0.400000,5
1000125,4,2,0.666667,0.333333,6
1000126,66,42,0.611111,0.388889,108
1000131,51,29,0.637500,0.362500,80
1000134,9,0,1.000000,0.000000,9
1000135,2,0,1.000000,0.000000,2
1000138,20,17,0.540541,0.459459,37
1000139,9,9,0.500000,0.500000,18
1000141,20,2,0.909091,0.090909,22
1000145,6,7,0.461538,0.538462,13
1000146,78,25,0.757282,0.242718,103
1002196,13,6,0.684211,0.315789,19
1002197,10,6,0.625000,0.375000,16
1000150,9,5,0.642857,0.357143,14
1000152,20,0,1.000000,0.000000,20
1002204,6,4,0.600000,0.400000,10
1000158,1,3,0.250000,0.750000,4
1002207,8,3,0.727273,0.272727,11
1000160,6,1,0.857143,0.142857,7
1000161,4,1,0.800000,0.200000,5
1000164,24,11,0.685714,0.314286,35
1000167,35,29,0.546875,0.453125,64
1000169,16,10,0.615385,0.384615,26
1002705,2,0,1.000000,0.000000,2
1000171,76,31,0.710280,0.289720,107
1000172,33,26,0.559322,0.440678,59
1000176,9,4,0.692308,0.307692,13
1000177,15,12,0.555556,0.444444,27
1000178,7,2,0.777778,0.222222,9
1000179,22,20,0.523810,0.476190,42
1000181,42,34,0.552632,0.447368,76
1000183,67,31,0.683673,0.316327,98
1000184,58,31,0.651685,0.348315,89
1000190,28,21,0.571429,0.428571,49
1002283,2,2,0.500000,0.500000,4
1000205,10,7,0.588235,0.411765,17
1000209,0,4,0.000000,1.000000,4
1000211,2,1,0.666667,0.333333,3
1000212,11,4,0.733333,0.266667,15
1000213,5,1,0.833333,0.166667,6
1000214,10,5,0.666667,0.333333,15
1000217,39,13,0.750000,0.250000,52
1000220,26,20,0.565217,0.434783,46
1000221,2,2,0.500000,0.500000,4
1002270,2,0,1.000000,0.000000,2
1000223,2,2,0.500000,0.500000,4
1000225,2,0,1.000000,0.000000,2
1000229,1,0,1.000000,0.000000,1
1000230,10,7,0.588235,0.411765,17
1000231,11,3,0.785714,0.214286,14
1000233,36,21,0.631579,0.368421,57
1002282,19,11,0.633333,0.366667,30
1000235,2,0,1.000000,0.000000,2
1002290,1,2,0.333333,0.666667,3
1000239,63,27,0.700000,0.300000,90
1000241,18,9,0.666667,0.333333,27
1000242,3,0,1.000000,0.000000,3
1000243,6,0,1.000000,0.000000,6
1002292,3,3,0.500000,0.500000,6
1002295,1,0,1.000000,0.000000,1
1000250,43,33,0.565789,0.434211,76
1000255,36,18,0.666667,0.333333,54
1000257,1,1,0.500000,0.500000,2
1000259,15,0,1.000000,0.000000,15
1000260,16,11,0.592593,0.407407,27
1000261,5,0,1.000000,0.000000,5
1002310,2,0,1.000000,0.000000,2
1000263,46,13,0.779661,0.220339,59
1000267,2,0,1.000000,0.000000,2
1000271,28,18,0.608696,0.391304,46
1000272,3,1,0.750000,0.250000,4
1000273,2,0,1.000000,0.000000,2
1000274,48,21,0.695652,0.304348,69
1000278,2,0,1.000000,0.000000,2
1000280,1,0,1.000000,0.000000,1
1002332,5,3,0.625000,0.375000,8
1000286,43,19,0.693548,0.306452,62
1002336,6,2,0.750000,0.250000,8
1000292,2,0,1.000000,0.000000,2
1001277,8,3,0.727273,0.272727,11
1000295,3,1,0.750000,0.250000,4
1002344,1,0,1.000000,0.000000,1
1000299,2,4,0.333333,0.666667,6
1000303,4,4,0.500000,0.500000,8
1000307,32,23,0.581818,0.418182,55
1000308,3,5,0.375000,0.625000,8
1002358,0,5,0.000000,1.000000,5
1002359,11,3,0.785714,0.214286,14
1000318,11,4,0.733333,0.266667,15
1000319,20,4,0.833333,0.166667,24
1002369,3,0,1.000000,0.000000,3
1000322,1,0,1.000000,0.000000,1
1000323,9,6,0.600000,0.400000,15
1000324,56,36,0.608696,0.391304,92
1002374,13,4,0.764706,0.235294,17
1000330,8,4,0.666667,0.333333,12
1000335,6,2,0.750000,0.250000,8
1000340,24,13,0.648649,0.351351,37
1000341,57,23,0.712500,0.287500,80
1000343,2,2,0.500000,0.500000,4
1002392,4,0,1.000000,0.000000,4
1000350,12,5,0.705882,0.294118,17
1002401,2,0,1.000000,0.000000,2
1000354,56,16,0.777778,0.222222,72
1000355,7,6,0.538462,0.461538,13
1000356,8,10,0.444444,0.555556,18
1000357,7,4,0.636364,0.363636,11
1000360,2,0,1.000000,0.000000,2
1000365,4,0,1.000000,0.000000,4
1002416,11,2,0.846154,0.153846,13
1002424,3,3,0.500000,0.500000,6
1000382,56,34,0.622222,0.377778,90
1000383,2,0,1.000000,0.000000,2
1002432,11,3,0.785714,0.214286,14
1002433,12,4,0.750000,0.250000,16
1000386,0,9,0.000000,1.000000,9
1000387,4,1,0.800000,0.200000,5
1000392,4,6,0.400000,0.600000,10
1000395,6,0,1.000000,0.000000,6
1000398,4,3,0.571429,0.428571,7
1002233,1,0,1.000000,0.000000,1
1000402,32,12,0.727273,0.272727,44
1002451,3,0,1.000000,0.000000,3
1000405,63,8,0.887324,0.112676,71
1002455,4,0,1.000000,0.000000,4
1000409,1,0,1.000000,0.000000,1
1002464,18,8,0.692308,0.307692,26
1002320,10,5,0.666667,0.333333,15
1002469,2,0,1.000000,0.000000,2
1002321,50,23,0.684932,0.315068,73
1002472,40,17,0.701754,0.298246,57
1000426,2,0,1.000000,0.000000,2
1000427,1,0,1.000000,0.000000,1
1002477,1,1,0.500000,0.500000,2
1000431,14,10,0.583333,0.416667,24
1000433,10,6,0.625000,0.375000,16
1002482,2,0,1.000000,0.000000,2
1000443,3,1,0.750000,0.250000,4
1000446,2,0,1.000000,0.000000,2
1000447,3,0,1.000000,0.000000,3
1000454,3,0,1.000000,0.000000,3
1000455,13,2,0.866667,0.133333,15
1000456,7,2,0.777778,0.222222,9
1002505,7,2,0.777778,0.222222,9
1000463,2,1,0.666667,0.333333,3
1000469,4,0,1.000000,0.000000,4
1000472,10,1,0.909091,0.090909,11
1000478,42,12,0.777778,0.222222,54
1000480,2,0,1.000000,0.000000,2
1000481,19,10,0.655172,0.344828,29
1002536,37,6,0.860465,0.139535,43
1002542,2,0,1.000000,0.000000,2
1000496,12,3,0.800000,0.200000,15
1002549,0,1,0.000000,1.000000,1
1000502,15,6,0.714286,0.285714,21
1000505,53,15,0.779412,0.220588,68
1000516,64,23,0.735632,0.264368,87
1002268,10,5,0.666667,0.333333,15
1000521,2,0,1.000000,0.000000,2
1000525,25,29,0.462963,0.537037,54
1002577,1,0,1.000000,0.000000,1
1000532,35,22,0.614035,0.385965,57
1002581,5,2,0.714286,0.285714,7
1002340,2,0,1.000000,0.000000,2
1000540,31,18,0.632653,0.367347,49
1002591,6,0,1.000000,0.000000,6
1002225,2,0,1.000000,0.000000,2
1002600,8,2,0.800000,0.200000,10
1000558,7,1,0.875000,0.125000,8
1002607,4,4,0.500000,0.500000,8
1002609,3,1,0.750000,0.250000,4
1000567,6,1,0.857143,0.142857,7
1002596,3,3,0.500000,0.500000,6
1000573,28,9,0.756757,0.243243,37
1000576,2,0,1.000000,0.000000,2
1000578,56,29,0.658824,0.341176,85
1000580,3,0,1.000000,0.000000,3
1000590,14,5,0.736842,0.263158,19
1002639,7,2,0.777778,0.222222,9
1002641,10,0,1.000000,0.000000,10
1002642,0,1,0.000000,1.000000,1
1002643,6,4,0.600000,0.400000,10
1002644,3,6,0.333333,0.666667,9
1002645,2,2,0.500000,0.500000,4
1000604,10,9,0.526316,0.473684,19
1002693,4,6,0.400000,0.600000,10
1000608,29,13,0.690476,0.309524,42
1002657,63,20,0.759036,0.240964,83
1000610,35,19,0.648148,0.351852,54
1000611,6,0,1.000000,0.000000,6
1000615,4,2,0.666667,0.333333,6
1002670,2,0,1.000000,0.000000,2
1002675,1,0,1.000000,0.000000,1
1002676,5,2,0.714286,0.285714,7
1000635,13,3,0.812500,0.187500,16
1000637,4,6,0.400000,0.600000,10
1000644,4,2,0.666667,0.333333,6
1000645,14,3,0.823529,0.176471,17
1000649,17,4,0.809524,0.190476,21
1000650,2,0,1.000000,0.000000,2
1002702,1,0,1.000000,0.000000,1
1002360,9,7,0.562500,0.437500,16
1000660,3,2,0.600000,0.400000,5
1000662,2,0,1.000000,0.000000,2
1000665,2,0,1.000000,0.000000,2
1000666,35,12,0.744681,0.255319,47
1002715,2,3,0.400000,0.600000,5
1000668,2,0,1.000000,0.000000,2
1000669,8,6,0.571429,0.428571,14
1002720,1,0,1.000000,0.000000,1
1000674,3,0,1.000000,0.000000,3
1000679,4,0,1.000000,0.000000,4
1000680,0,2,0.000000,1.000000,2
1000682,2,0,1.000000,0.000000,2
1002744,6,3,0.666667,0.333333,9
1000698,2,3,0.400000,0.600000,5
1002749,32,4,0.888889,0.111111,36
1002752,10,8,0.555556,0.444444,18
1000724,2,1,0.666667,0.333333,3
1002713,3,1,0.750000,0.250000,4
1000731,3,0,1.000000,0.000000,3
1002782,2,1,0.666667,0.333333,3
1000736,4,0,1.000000,0.000000,4
1002785,8,0,1.000000,0.000000,8
1000739,18,7,0.720000,0.280000,25
1000744,34,21,0.618182,0.381818,55
1000746,4,1,0.800000,0.200000,5
1000748,14,10,0.583333,0.416667,24
1000750,12,8,0.600000,0.400000,20
1002376,2,0,1.000000,0.000000,2
1000755,2,5,0.285714,0.714286,7
1002111,2,0,1.000000,0.000000,2
1000765,50,13,0.793651,0.206349,63
1000769,5,0,1.000000,0.000000,5
1002820,4,2,0.666667,0.333333,6
1002821,9,3,0.750000,0.250000,12
1000774,2,4,0.333333,0.666667,6
1002829,2,0,1.000000,0.000000,2
1002831,3,2,0.600000,0.400000,5
1000787,2,0,1.000000,0.000000,2
1002838,2,1,0.666667,0.333333,3
1000794,2,0,1.000000,0.000000,2
1002848,13,5,0.722222,0.277778,18
1002849,3,3,0.500000,0.500000,6
1002853,13,4,0.764706,0.235294,17
1000809,41,15,0.732143,0.267857,56
1002727,2,0,1.000000,0.000000,2
1000816,2,1,0.666667,0.333333,3
1002865,3,2,0.600000,0.400000,5
1000818,20,14,0.588235,0.411765,34
1000823,22,8,0.733333,0.266667,30
1002730,2,1,0.666667,0.333333,3
1000835,64,17,0.790123,0.209877,81
1000837,2,0,1.000000,0.000000,2
1000842,2,0,1.000000,0.000000,2
1000844,35,3,0.921053,0.078947,38
1002051,8,3,0.727273,0.272727,11
1000859,3,0,1.000000,0.000000,3
1000861,7,2,0.777778,0.222222,9
1000868,3,0,1.000000,0.000000,3
1002251,2,0,1.000000,0.000000,2
1000873,4,2,0.666667,0.333333,6
1000876,2,0,1.000000,0.000000,2
1000881,58,36,0.617021,0.382979,94
1002930,3,9,0.250000,0.750000,12
1002932,9,2,0.818182,0.181818,11
1000901,60,24,0.714286,0.285714,84
1002060,4,2,0.666667,0.333333,6
1002402,1,0,1.000000,0.000000,1
1000913,2,0,1.000000,0.000000,2
1002064,2,1,0.666667,0.333333,3
1002253,4,1,0.800000,0.200000,5
1000935,65,34,0.656566,0.343434,99
1000936,24,16,0.600000,0.400000,40
1002526,3,2,0.600000,0.400000,5
1000944,4,0,1.000000,0.000000,4
1002068,27,14,0.658537,0.341463,41
1000957,4,0,1.000000,0.000000,4
1000964,2,0,1.000000,0.000000,2
1000972,39,3,0.928571,0.071429,42
1000973,29,25,0.537037,0.462963,54
1002413,2,0,1.000000,0.000000,2
1000977,26,12,0.684211,0.315789,38
1002255,1,0,1.000000,0.000000,1
1000993,6,3,0.666667,0.333333,9
1001001,19,3,0.863636,0.136364,22
1001004,7,2,0.777778,0.222222,9
1001005,8,3,0.727273,0.272727,11
1002125,12,5,0.705882,0.294118,17
1002078,1,0,1.000000,0.000000,1
1002080,3,2,0.600000,0.400000,5
1001026,39,39,0.500000,0.500000,78
1002081,2,0,1.000000,0.000000,2
1001035,12,1,0.923077,0.076923,13
1001039,16,17,0.484848,0.515152,33
1001040,16,18,0.470588,0.529412,34
1001058,9,19,0.321429,0.678571,28
1001065,15,2,0.882353,0.117647,17
1001069,1,3,0.250000,0.750000,4
1001079,52,15,0.776119,0.223881,67
1001080,15,8,0.652174,0.347826,23
1001081,2,0,1.000000,0.000000,2
1002092,2,0,1.000000,0.000000,2
1002054,36,30,0.545455,0.454545,66
1001102,2,0,1.000000,0.000000,2
1002093,49,39,0.556818,0.443182,88
1002435,4,1,0.800000,0.200000,5
1001114,1,0,1.000000,0.000000,1
1001121,2,0,1.000000,0.000000,2
1002097,0,2,0.000000,1.000000,2
1001130,4,3,0.571429,0.428571,7
1001132,56,33,0.629213,0.370787,89
1002192,42,7,0.857143,0.142857,49
1001156,30,19,0.612245,0.387755,49
1001163,13,1,0.928571,0.071429,14
1001168,2,3,0.400000,0.600000,5
1001184,6,0,1.000000,0.000000,6
1001186,5,3,0.625000,0.375000,8
1001187,11,4,0.733333,0.266667,15
1000401,0,5,0.000000,1.000000,5
1001195,33,8,0.804878,0.195122,41
1001198,17,3,0.850000,0.150000,20
1001203,8,4,0.666667,0.333333,12
1001210,2,0,1.000000,0.000000,2
1001211,61,4,0.938462,0.061538,65
1001212,2,0,1.000000,0.000000,2
1001221,5,2,0.714286,0.285714,7
1001229,4,1,0.800000,0.200000,5
1001237,4,1,0.800000,0.200000,5
1001239,2,2,0.500000,0.500000,4
1001240,2,2,0.500000,0.500000,4
1001245,6,3,0.666667,0.333333,9
1001246,17,3,0.850000,0.150000,20
1001248,5,4,0.555556,0.444444,9
1002122,45,14,0.762712,0.237288,59
1001100,13,10,0.565217,0.434783,23
1002807,2,0,1.000000,0.000000,2
1001295,1,0,1.000000,0.000000,1
1002126,3,0,1.000000,0.000000,3
1001303,8,10,0.444444,0.555556,18
1001311,7,2,0.777778,0.222222,9
1001312,5,3,0.625000,0.375000,8
1001335,2,1,0.666667,0.333333,3
1001340,2,0,1.000000,0.000000,2
1002133,1,0,1.000000,0.000000,1
1001352,46,20,0.696970,0.303030,66
1001353,6,0,1.000000,0.000000,6
1002135,2,0,1.000000,0.000000,2
1002138,2,2,0.500000,0.500000,4
1001377,18,9,0.666667,0.333333,27
1002140,7,6,0.538462,0.461538,13
1001387,15,2,0.882353,0.117647,17
1002141,2,0,1.000000,0.000000,2
1001392,7,3,0.700000,0.300000,10
1002142,12,6,0.666667,0.333333,18
1001401,3,1,0.750000,0.250000,4
1001409,4,9,0.307692,0.692308,13
1001412,1,0,1.000000,0.000000,1
1001415,2,0,1.000000,0.000000,2
1002146,2,1,0.666667,0.333333,3
1002065,35,15,0.700000,0.300000,50
1001431,2,1,0.666667,0.333333,3
1002148,3,3,0.500000,0.500000,6
1002149,2,1,0.666667,0.333333,3
1001441,2,0,1.000000,0.000000,2
1001457,0,1,0.000000,1.000000,1
1002495,2,2,0.500000,0.500000,4
