1000049,{graveyard}/qtbinaryjson,5,1,6,0.833333,0.166667
1000971,{graveyard}/qtbinaryjson,2,2,4,0.500000,0.500000
1000023,{graveyard}/qtbinaryjson,1,0,1,1.000000,0.000000
1000049,{graveyard}/qtphonon,17,4,21,0.809524,0.190476
1000971,{graveyard}/qtphonon,2,0,2,1.000000,0.000000
1000023,{graveyard}/qtphonon,3,2,5,0.600000,0.400000
1000049,{graveyard}/qtx11support,7,1,8,0.875000,0.125000
1000331,{graveyard}/qtx11support,5,0,5,1.000000,0.000000
1001100,{graveyard}/qtx11support,1,0,1,1.000000,0.000000
1000971,installer-framework/installer-framework,0,1,1,0.000000,1.000000
1000199,installer-framework/installer-framework,446,305,751,0.593875,0.406125
1000329,installer-framework/installer-framework,1,0,1,1.000000,0.000000
1000331,installer-framework/installer-framework,2,3,5,0.400000,0.600000
1000082,installer-framework/installer-framework,14,6,20,0.700000,0.300000
1000217,installer-framework/installer-framework,6,3,9,0.666667,0.333333
1001796,installer-framework/installer-framework,8,4,12,0.666667,0.333333
1000731,installer-framework/installer-framework,3,0,3,1.000000,0.000000
1000098,installer-framework/installer-framework,23,5,28,0.821429,0.178571
1000100,installer-framework/installer-framework,1,0,1,1.000000,0.000000
1001764,installer-framework/installer-framework,2,0,2,1.000000,0.000000
1000109,installer-framework/installer-framework,127,101,228,0.557018,0.442982
1001288,installer-framework/installer-framework,10,4,14,0.714286,0.285714
1002831,installer-framework/installer-framework,3,2,5,0.600000,0.400000
1000120,installer-framework/installer-framework,6,2,8,0.750000,0.250000
1000126,installer-framework/installer-framework,18,8,26,0.692308,0.307692
1000130,installer-framework/installer-framework,1,3,4,0.250000,0.750000
1000003,installer-framework/installer-framework,161,94,255,0.631373,0.368627
1000004,installer-framework/installer-framework,4,0,4,1.000000,0.000000
1000006,installer-framework/installer-framework,3,2,5,0.600000,0.400000
1000008,installer-framework/installer-framework,18,12,30,0.600000,0.400000
1000013,installer-framework/installer-framework,3,1,4,0.750000,0.250000
1000014,installer-framework/installer-framework,3,4,7,0.428571,0.571429
1000015,installer-framework/installer-framework,14,6,20,0.700000,0.300000
1000017,installer-framework/installer-framework,728,335,1063,0.684854,0.315146
1002838,installer-framework/installer-framework,2,1,3,0.666667,0.333333
1000023,installer-framework/installer-framework,12,7,19,0.631579,0.368421
1000025,installer-framework/installer-framework,3,1,4,0.750000,0.250000
1000026,installer-framework/installer-framework,44,34,78,0.564103,0.435897
1001295,installer-framework/installer-framework,1,0,1,1.000000,0.000000
1000286,installer-framework/installer-framework,39,19,58,0.672414,0.327586
1000681,installer-framework/installer-framework,7,2,9,0.777778,0.222222
1000173,installer-framework/installer-framework,2,0,2,1.000000,0.000000
1001454,installer-framework/installer-framework,45,20,65,0.692308,0.307692
1000049,installer-framework/installer-framework,2577,1408,3985,0.646675,0.353325
1000053,installer-framework/installer-framework,1,2,3,0.333333,0.666667
1000566,installer-framework/installer-framework,2,0,2,1.000000,0.000000
1001982,installer-framework/installer-framework,5,2,7,0.714286,0.285714
1000049,playground/alignedtimer,11,0,11,1.000000,0.000000
1000023,playground/alignedtimer,1,0,1,1.000000,0.000000
1000971,playground/mimetypes,2,0,2,1.000000,0.000000
1000049,playground/mimetypes,109,39,148,0.736486,0.263514
1000259,playground/mimetypes,11,0,11,1.000000,0.000000
1000334,playground/mimetypes,18,16,34,0.529412,0.470588
1000023,playground/mimetypes,1,0,1,1.000000,0.000000
1000097,playground/qlogger,11,10,21,0.523810,0.476190
1000004,playground/qlogger,1,2,3,0.333333,0.666667
1000023,playground/qlogger,1,0,1,1.000000,0.000000
1000971,playground/qlogger,2,0,2,1.000000,0.000000
1000049,playground/qlogger,63,17,80,0.787500,0.212500
1001431,playground/qlogger,2,1,3,0.666667,0.333333
1000250,playground/qlogger,12,6,18,0.666667,0.333333
1000049,playground/qtaudio3d,6,2,8,0.750000,0.250000
1000023,playground/qtaudio3d,1,0,1,1.000000,0.000000
1000127,playground/qtaudio3d,1,2,3,0.333333,0.666667
1000037,playground/qtbinaryjson,7,8,15,0.466667,0.533333
1000327,playground/qtbinaryjson,6,3,9,0.666667,0.333333
1000049,playground/qtbinaryjson,134,35,169,0.792899,0.207101
1000818,playground/qtbinaryjson,2,0,2,1.000000,0.000000
1000216,playground/qtbinaryjson,2,0,2,1.000000,0.000000
1000121,playground/qtbinaryjson,6,3,9,0.666667,0.333333
1000049,playground/qt-creator/plugin-gammaray,12,0,12,1.000000,0.000000
1000023,playground/qt-creator/plugin-gammaray,1,0,1,1.000000,0.000000
1000049,playground/qt-creator/plugin-scripting,142,83,225,0.631111,0.368889
1000410,playground/qt-creator/plugin-scripting,16,19,35,0.457143,0.542857
1000661,playground/qt-creator/plugin-scripting,1,0,1,1.000000,0.000000
1002433,playground/qt-creator/plugin-scripting,12,2,14,0.857143,0.142857
1000049,playground/qtdesktopcomponents,62,7,69,0.898551,0.101449
1000043,playground/qtdesktopcomponents,9,0,9,1.000000,0.000000
1000014,playground/qtdesktopcomponents,4,0,4,1.000000,0.000000
1000503,playground/qtdesktopcomponents,3,2,5,0.600000,0.400000
1000049,playground/qtjsonstream,124,70,194,0.639175,0.360825
1000818,playground/qtjsonstream,14,10,24,0.583333,0.416667
1001203,playground/qtjsonstream,8,4,12,0.666667,0.333333
1000023,playground/qtjsonstream,1,0,1,1.000000,0.000000
1000160,playground/qtprocessmanager,2,0,2,1.000000,0.000000
1000161,playground/qtprocessmanager,4,1,5,0.800000,0.200000
1000261,playground/qtprocessmanager,2,0,2,1.000000,0.000000
1001069,playground/qtprocessmanager,1,3,4,0.250000,0.750000
1000049,playground/qtprocessmanager,161,60,221,0.728507,0.271493
1000818,playground/qtprocessmanager,4,4,8,0.500000,0.500000
1000050,playground/qtprocessmanager,4,3,7,0.571429,0.428571
1000023,playground/qtprocessmanager,1,0,1,1.000000,0.000000
1001566,playground/qtprocessmanager,2,0,2,1.000000,0.000000
1001567,playground/qtprocessmanager,2,0,2,1.000000,0.000000
1000327,playground/qtserialport,8,3,11,0.727273,0.272727
1000681,playground/qtserialport,2,2,4,0.500000,0.500000
1000043,playground/qtserialport,0,2,2,0.000000,1.000000
1000942,playground/qtserialport,8,8,16,0.500000,0.500000
1000528,playground/qtserialport,16,3,19,0.842105,0.157895
1000049,playground/qtserialport,169,95,264,0.640152,0.359848
1000503,playground/qtserialport,12,6,18,0.666667,0.333333
1000312,playground/qtserialport,37,5,42,0.880952,0.119048
1000124,playground/qtserialport,2,0,2,1.000000,0.000000
1000413,playground/qtserialport,103,26,129,0.798450,0.201550
1000049,playground/qtsystemtest,12,3,15,0.800000,0.200000
1000178,playground/qtsystemtest,3,0,3,1.000000,0.000000
1000134,playground/qtsystemtest,3,0,3,1.000000,0.000000
1002126,playground/qtsystemtest,3,0,3,1.000000,0.000000
1000023,playground/qtsystemtest,2,0,2,1.000000,0.000000
1000049,playground/scenegraph,86,33,119,0.722689,0.277311
1000023,playground/scenegraph,3,0,3,1.000000,0.000000
1000004,playground/scenegraph,5,0,5,1.000000,0.000000
1000105,playground/scenegraph,12,5,17,0.705882,0.294118
1000455,playground/uihelpers,6,0,6,1.000000,0.000000
1001001,playground/uihelpers,15,3,18,0.833333,0.166667
1001802,playground/uihelpers,2,0,2,1.000000,0.000000
1000971,playground/uihelpers,1,0,1,1.000000,0.000000
1001004,playground/uihelpers,4,0,4,1.000000,0.000000
1000049,playground/uihelpers,121,82,203,0.596059,0.403941
1000402,playground/uihelpers,18,11,29,0.620690,0.379310
1000023,playground/uihelpers,1,0,1,1.000000,0.000000
1000005,playground/v4vm,26,17,43,0.604651,0.395349
1000331,playground/v4vm,0,2,2,0.000000,1.000000
1000049,playground/v4vm,1997,539,2536,0.787461,0.212539
1000019,playground/v4vm,11,19,30,0.366667,0.633333
1000312,playground/v4vm,2,0,2,1.000000,0.000000
1000121,playground/v4vm,66,54,120,0.550000,0.450000
1000091,playground/v4vm,1,0,1,1.000000,0.000000
1000004,playground/websockets,1,0,1,1.000000,0.000000
1000049,playground/websockets,232,47,279,0.831541,0.168459
1000604,playground/websockets,2,0,2,1.000000,0.000000
1002749,playground/websockets,9,2,11,0.818182,0.181818
1000023,playground/websockets,5,4,9,0.555556,0.444444
1000049,pyside/apiextractor,2,0,2,1.000000,0.000000
1000023,pyside/apiextractor,2,0,2,1.000000,0.000000
1000049,pyside/generatorrunner,2,0,2,1.000000,0.000000
1000023,pyside/generatorrunner,2,0,2,1.000000,0.000000
1002528,pyside/pyside,2,1,3,0.666667,0.333333
1001994,pyside/pyside,2,2,4,0.500000,0.500000
1000971,pyside/pyside,2,3,5,0.400000,0.600000
1001612,pyside/pyside,6,0,6,1.000000,0.000000
1001005,pyside/pyside,1,2,3,0.333333,0.666667
1000049,pyside/pyside,77,37,114,0.675439,0.324561
1000023,pyside/pyside,2,1,3,0.666667,0.333333
1001946,pyside/pyside,2,2,4,0.500000,0.500000
1001611,pyside/shiboken,3,0,3,1.000000,0.000000
1001994,pyside/shiboken,10,2,12,0.833333,0.166667
1002455,pyside/shiboken,4,0,4,1.000000,0.000000
1001612,pyside/shiboken,8,0,8,1.000000,0.000000
1001005,pyside/shiboken,7,1,8,0.875000,0.125000
1000049,pyside/shiboken,117,47,164,0.713415,0.286585
1000023,pyside/shiboken,2,0,2,1.000000,0.000000
1002520,pyside/shiboken,2,0,2,1.000000,0.000000
1001946,pyside/shiboken,4,0,4,1.000000,0.000000
1000049,qt-apps/snowshoe,4,3,7,0.571429,0.428571
1000455,qt-apps/snowshoe,2,0,2,1.000000,0.000000
1000263,qt-apps/snowshoe,2,0,2,1.000000,0.000000
1000448,qt-creator/qt-creator,68,35,103,0.660194,0.339806
1000022,qt-creator/qt-creator,13,9,22,0.590909,0.409091
1000456,qt-creator/qt-creator,2,0,2,1.000000,0.000000
1000973,qt-creator/qt-creator,2,0,2,1.000000,0.000000
1002008,qt-creator/qt-creator,2,0,2,1.000000,0.000000
1000942,qt-creator/qt-creator,2,2,4,0.500000,0.500000
1000478,qt-creator/qt-creator,39,12,51,0.764706,0.235294
1000481,qt-creator/qt-creator,16,8,24,0.666667,0.333333
1002536,qt-creator/qt-creator,2,0,2,1.000000,0.000000
1000028,qt-creator/qt-creator,9,13,22,0.409091,0.590909
1002542,qt-creator/qt-creator,2,0,2,1.000000,0.000000
1002031,qt-creator/qt-creator,154,55,209,0.736842,0.263158
1000496,qt-creator/qt-creator,8,2,10,0.800000,0.200000
1000502,qt-creator/qt-creator,15,6,21,0.714286,0.285714
1000503,qt-creator/qt-creator,15,3,18,0.833333,0.166667
1000505,qt-creator/qt-creator,53,15,68,0.779412,0.220588
1002080,qt-creator/qt-creator,3,2,5,0.600000,0.400000
1000003,qt-creator/qt-creator,551,381,932,0.591202,0.408798
1000004,qt-creator/qt-creator,543,312,855,0.635088,0.364912
1000006,qt-creator/qt-creator,51,23,74,0.689189,0.310811
1000007,qt-creator/qt-creator,1073,608,1681,0.638311,0.361689
1001032,qt-creator/qt-creator,1,0,1,1.000000,0.000000
1000009,qt-creator/qt-creator,1045,708,1753,0.596121,0.403879
1000010,qt-creator/qt-creator,92,83,175,0.525714,0.474286
1000011,qt-creator/qt-creator,306,146,452,0.676991,0.323009
1000012,qt-creator/qt-creator,153,103,256,0.597656,0.402344
1000013,qt-creator/qt-creator,381,203,584,0.652397,0.347603
1000014,qt-creator/qt-creator,505,300,805,0.627329,0.372671
1000015,qt-creator/qt-creator,595,369,964,0.617220,0.382780
1000528,qt-creator/qt-creator,103,69,172,0.598837,0.401163
1000017,qt-creator/qt-creator,33,10,43,0.767442,0.232558
1000018,qt-creator/qt-creator,62,42,104,0.596154,0.403846
1000019,qt-creator/qt-creator,135,103,238,0.567227,0.432773
1000020,qt-creator/qt-creator,138,95,233,0.592275,0.407725
1000534,qt-creator/qt-creator,1087,438,1525,0.712787,0.287213
1000023,qt-creator/qt-creator,7,6,13,0.538462,0.461538
1000024,qt-creator/qt-creator,54,55,109,0.495413,0.504587
1000026,qt-creator/qt-creator,445,249,694,0.641210,0.358790
1000027,qt-creator/qt-creator,125,91,216,0.578704,0.421296
1000540,qt-creator/qt-creator,31,18,49,0.632653,0.367347
1000029,qt-creator/qt-creator,14,13,27,0.518519,0.481481
1000030,qt-creator/qt-creator,76,51,127,0.598425,0.401575
1000032,qt-creator/qt-creator,11,2,13,0.846154,0.153846
1000036,qt-creator/qt-creator,8,5,13,0.615385,0.384615
1000043,qt-creator/qt-creator,0,2,2,0.000000,1.000000
1002093,qt-creator/qt-creator,2,0,2,1.000000,0.000000
1000558,qt-creator/qt-creator,3,0,3,1.000000,0.000000
1002095,qt-creator/qt-creator,6,8,14,0.428571,0.571429
1000049,qt-creator/qt-creator,28775,14809,43584,0.660219,0.339781
1000050,qt-creator/qt-creator,2,1,3,0.666667,0.333333
1000051,qt-creator/qt-creator,4,2,6,0.666667,0.333333
1000052,qt-creator/qt-creator,4,3,7,0.571429,0.428571
1000565,qt-creator/qt-creator,26,8,34,0.764706,0.235294
1000054,qt-creator/qt-creator,11,7,18,0.611111,0.388889
1000055,qt-creator/qt-creator,1,2,3,0.333333,0.666667
1000057,qt-creator/qt-creator,26,18,44,0.590909,0.409091
1000061,qt-creator/qt-creator,128,84,212,0.603774,0.396226
1000576,qt-creator/qt-creator,2,0,2,1.000000,0.000000
1002113,qt-creator/qt-creator,2,1,3,0.666667,0.333333
1002433,qt-creator/qt-creator,0,2,2,0.000000,1.000000
1000074,qt-creator/qt-creator,5,3,8,0.625000,0.375000
1001100,qt-creator/qt-creator,0,6,6,0.000000,1.000000
1000079,qt-creator/qt-creator,3,3,6,0.500000,0.500000
1001616,qt-creator/qt-creator,18,4,22,0.818182,0.181818
1000082,qt-creator/qt-creator,9,0,9,1.000000,0.000000
1000083,qt-creator/qt-creator,4,2,6,0.666667,0.333333
1000084,qt-creator/qt-creator,24,14,38,0.631579,0.368421
1000644,qt-creator/qt-creator,2,0,2,1.000000,0.000000
1000091,qt-creator/qt-creator,1,2,3,0.333333,0.666667
1000093,qt-creator/qt-creator,0,1,1,0.000000,1.000000
1000094,qt-creator/qt-creator,2,7,9,0.222222,0.777778
1001454,qt-creator/qt-creator,5,0,5,1.000000,0.000000
1000096,qt-creator/qt-creator,117,55,172,0.680233,0.319767
1000101,qt-creator/qt-creator,1,0,1,1.000000,0.000000
1002152,qt-creator/qt-creator,64,18,82,0.780488,0.219512
1000108,qt-creator/qt-creator,5,4,9,0.555556,0.444444
1000109,qt-creator/qt-creator,57,31,88,0.647727,0.352273
1000110,qt-creator/qt-creator,21,5,26,0.807692,0.192308
1000120,qt-creator/qt-creator,114,58,172,0.662791,0.337209
1000121,qt-creator/qt-creator,4,0,4,1.000000,0.000000
1000123,qt-creator/qt-creator,0,1,1,0.000000,1.000000
1000124,qt-creator/qt-creator,3,6,9,0.333333,0.666667
1000637,qt-creator/qt-creator,4,6,10,0.400000,0.600000
1000126,qt-creator/qt-creator,13,7,20,0.650000,0.350000
1001248,qt-creator/qt-creator,5,4,9,0.555556,0.444444
1000130,qt-creator/qt-creator,3,2,5,0.600000,0.400000
1001419,qt-creator/qt-creator,14,4,18,0.777778,0.222222
1000132,qt-creator/qt-creator,44,38,82,0.536585,0.463415
1000134,qt-creator/qt-creator,2,0,2,1.000000,0.000000
1000649,qt-creator/qt-creator,17,4,21,0.809524,0.190476
1000140,qt-creator/qt-creator,2,0,2,1.000000,0.000000
1002702,qt-creator/qt-creator,1,0,1,1.000000,0.000000
1002192,qt-creator/qt-creator,3,0,3,1.000000,0.000000
1000660,qt-creator/qt-creator,3,2,5,0.600000,0.400000
1000661,qt-creator/qt-creator,4,0,4,1.000000,0.000000
1000662,qt-creator/qt-creator,2,0,2,1.000000,0.000000
1000153,qt-creator/qt-creator,806,459,1265,0.637154,0.362846
1001690,qt-creator/qt-creator,2,1,3,0.666667,0.333333
1000155,qt-creator/qt-creator,4,0,4,1.000000,0.000000
1002207,qt-creator/qt-creator,6,3,9,0.666667,0.333333
1000164,qt-creator/qt-creator,6,3,9,0.666667,0.333333
1000166,qt-creator/qt-creator,2,0,2,1.000000,0.000000
1000679,qt-creator/qt-creator,4,0,4,1.000000,0.000000
1000680,qt-creator/qt-creator,0,2,2,0.000000,1.000000
1000681,qt-creator/qt-creator,38,12,50,0.760000,0.240000
1000682,qt-creator/qt-creator,2,0,2,1.000000,0.000000
1002219,qt-creator/qt-creator,224,83,307,0.729642,0.270358
1000173,qt-creator/qt-creator,210,158,368,0.570652,0.429348
1000178,qt-creator/qt-creator,4,2,6,0.666667,0.333333
1002196,qt-creator/qt-creator,11,6,17,0.647059,0.352941
1002749,qt-creator/qt-creator,5,0,5,1.000000,0.000000
1002197,qt-creator/qt-creator,2,0,2,1.000000,0.000000
1000708,qt-creator/qt-creator,2,0,2,1.000000,0.000000
1000199,qt-creator/qt-creator,14,9,23,0.608696,0.391304
1002253,qt-creator/qt-creator,4,1,5,0.800000,0.200000
1000207,qt-creator/qt-creator,2,0,2,1.000000,0.000000
1002263,qt-creator/qt-creator,225,117,342,0.657895,0.342105
1000217,qt-creator/qt-creator,3,2,5,0.600000,0.400000
1002270,qt-creator/qt-creator,2,0,2,1.000000,0.000000
1000736,qt-creator/qt-creator,1,0,1,1.000000,0.000000
1002785,qt-creator/qt-creator,8,0,8,1.000000,0.000000
1000738,qt-creator/qt-creator,10,6,16,0.625000,0.375000
1002715,qt-creator/qt-creator,2,3,5,0.400000,0.600000
1002279,qt-creator/qt-creator,14,6,20,0.700000,0.300000
1000071,qt-creator/qt-creator,2,4,6,0.333333,0.666667
1000748,qt-creator/qt-creator,14,10,24,0.583333,0.416667
1002286,qt-creator/qt-creator,4,0,4,1.000000,0.000000
1001775,qt-creator/qt-creator,16,16,32,0.500000,0.500000
1002290,qt-creator/qt-creator,1,2,3,0.333333,0.666667
1000762,qt-creator/qt-creator,4,0,4,1.000000,0.000000
1001796,qt-creator/qt-creator,0,6,6,0.000000,1.000000
1000774,qt-creator/qt-creator,2,4,6,0.333333,0.666667
1000263,qt-creator/qt-creator,8,0,8,1.000000,0.000000
1001288,qt-creator/qt-creator,59,28,87,0.678161,0.321839
1000271,qt-creator/qt-creator,2,2,4,0.500000,0.500000
1000785,qt-creator/qt-creator,8,4,12,0.666667,0.333333
1000794,qt-creator/qt-creator,2,0,2,1.000000,0.000000
1000286,qt-creator/qt-creator,4,0,4,1.000000,0.000000
1000592,qt-creator/qt-creator,0,2,2,0.000000,1.000000
1001190,qt-creator/qt-creator,9,4,13,0.692308,0.307692
1000809,qt-creator/qt-creator,2,0,2,1.000000,0.000000
1000298,qt-creator/qt-creator,8,2,10,0.800000,0.200000
1000816,qt-creator/qt-creator,2,1,3,0.666667,0.333333
1001619,qt-creator/qt-creator,2,3,5,0.400000,0.600000
1000822,qt-creator/qt-creator,3,2,5,0.600000,0.400000
1001335,qt-creator/qt-creator,2,1,3,0.666667,0.333333
1000312,qt-creator/qt-creator,44,7,51,0.862745,0.137255
1000318,qt-creator/qt-creator,3,2,5,0.600000,0.400000
1001195,qt-creator/qt-creator,10,1,11,0.909091,0.090909
1000837,qt-creator/qt-creator,2,0,2,1.000000,0.000000
1000327,qt-creator/qt-creator,4,0,4,1.000000,0.000000
1000329,qt-creator/qt-creator,21,12,33,0.636364,0.363636
1000330,qt-creator/qt-creator,4,0,4,1.000000,0.000000
1000338,qt-creator/qt-creator,1,2,3,0.333333,0.666667
1002051,qt-creator/qt-creator,4,0,4,1.000000,0.000000
1000341,qt-creator/qt-creator,18,10,28,0.642857,0.357143
1002694,qt-creator/qt-creator,96,39,135,0.711111,0.288889
1000356,qt-creator/qt-creator,8,10,18,0.444444,0.555556
1000869,qt-creator/qt-creator,2,1,3,0.666667,0.333333
1001382,qt-creator/qt-creator,262,97,359,0.729805,0.270195
1000359,qt-creator/qt-creator,58,41,99,0.585859,0.414141
1000360,qt-creator/qt-creator,2,0,2,1.000000,0.000000
1000008,qt-creator/qt-creator,12,4,16,0.750000,0.250000
1002932,qt-creator/qt-creator,9,2,11,0.818182,0.181818
1000383,qt-creator/qt-creator,2,0,2,1.000000,0.000000
1002144,qt-creator/qt-creator,4,8,12,0.333333,0.666667
1001035,qt-creator/qt-creator,12,1,13,0.923077,0.076923
1001415,qt-creator/qt-creator,2,0,2,1.000000,0.000000
1000392,qt-creator/qt-creator,4,6,10,0.400000,0.600000
1000395,qt-creator/qt-creator,6,0,6,1.000000,0.000000
1002849,qt-creator/qt-creator,3,3,6,0.500000,0.500000
1000912,qt-creator/qt-creator,172,124,296,0.581081,0.418919
1001380,qt-creator/qt-creator,1,0,1,1.000000,0.000000
1000410,qt-creator/qt-creator,183,95,278,0.658273,0.341727
1000413,qt-creator/qt-creator,12,6,18,0.666667,0.333333
1002321,qt-creator/qt-creator,12,14,26,0.461538,0.538462
1002577,qt-creator/qt-creator,1,0,1,1.000000,0.000000
1002065,qt-creator/qt-creator,35,15,50,0.700000,0.300000
1000530,qt-creator/qt-creator,10,1,11,0.909091,0.090909
1001966,qt-creator/qt-creator,3,2,5,0.600000,0.400000
1001967,qt-creator/qt-creator,22,7,29,0.758621,0.241379
1002482,qt-creator/qt-creator,2,0,2,1.000000,0.000000
1001973,qt-creator/qt-creator,1,0,1,1.000000,0.000000
1002068,qt-creator/qt-creator,2,2,4,0.500000,0.500000
1000959,qt-creator/qt-creator,426,270,696,0.612069,0.387931
1000049,qt-labs/chromium,18,2,20,0.900000,0.100000
1000181,qt-labs/chromium,2,3,5,0.400000,0.600000
1000193,qt-labs/chromium,0,2,2,0.000000,1.000000
1000049,qt-labs/jira2gv,10,0,10,1.000000,0.000000
1000023,qt-labs/jira2gv,2,0,2,1.000000,0.000000
1000120,qt-labs/jom,3,2,5,0.600000,0.400000
1000049,qt-labs/jom,205,38,243,0.843621,0.156379
1000645,qt-labs/jom,2,0,2,1.000000,0.000000
1002281,qt-labs/jom,2,0,2,1.000000,0.000000
1000098,qt-labs/messagingframework,2,0,2,1.000000,0.000000
1000004,qt-labs/messagingframework,3,2,5,0.600000,0.400000
1000327,qt-labs/messagingframework,12,6,18,0.666667,0.333333
1001065,qt-labs/messagingframework,15,2,17,0.882353,0.117647
1002122,qt-labs/messagingframework,11,5,16,0.687500,0.312500
1001100,qt-labs/messagingframework,1,0,1,1.000000,0.000000
1000049,qt-labs/messagingframework,55,33,88,0.625000,0.375000
1000023,qt-labs/messagingframework,2,0,2,1.000000,0.000000
1000324,qt-labs/messagingframework,2,0,2,1.000000,0.000000
1000049,qt-labs/photoshop-qmlexporter,4,1,5,0.800000,0.200000
1000023,qt-labs/photoshop-qmlexporter,1,0,1,1.000000,0.000000
1000964,qt-labs/qbs,2,0,2,1.000000,0.000000
1000481,qt-labs/qbs,1,2,3,0.333333,0.666667
1000359,qt-labs/qbs,7,1,8,0.875000,0.125000
1001516,qt-labs/qbs,2,3,5,0.400000,0.600000
1000750,qt-labs/qbs,2,0,2,1.000000,0.000000
1000120,qt-labs/qbs,273,240,513,0.532164,0.467836
1000004,qt-labs/qbs,317,140,457,0.693654,0.306346
1000009,qt-labs/qbs,12,36,48,0.250000,0.750000
1000010,qt-labs/qbs,14,7,21,0.666667,0.333333
1000011,qt-labs/qbs,228,87,315,0.723810,0.276190
1000012,qt-labs/qbs,2,1,3,0.666667,0.333333
1000014,qt-labs/qbs,2,1,3,0.666667,0.333333
1000530,qt-labs/qbs,210,61,271,0.774908,0.225092
1000019,qt-labs/qbs,1,0,1,1.000000,0.000000
1000534,qt-labs/qbs,44,16,60,0.733333,0.266667
1000153,qt-labs/qbs,2,0,2,1.000000,0.000000
1000026,qt-labs/qbs,30,23,53,0.566038,0.433962
1000173,qt-labs/qbs,6,2,8,0.750000,0.250000
1000942,qt-labs/qbs,2,2,4,0.500000,0.500000
1000049,qt-labs/qbs,3287,1776,5063,0.649220,0.350780
1000312,qt-labs/qbs,2,0,2,1.000000,0.000000
1001980,qt-labs/qbs,1,7,8,0.125000,0.875000
1000061,qt-labs/qbs,1,2,3,0.333333,0.666667
1000049,qt-labs/qml-presentation-system,12,6,18,0.666667,0.333333
1000049,qt-labs/qsettings-refactor,10,0,10,1.000000,0.000000
1000049,qt-labs/qtaddonmimetype,27,6,33,0.818182,0.181818
1000971,qt-labs/qtaddonmimetype,2,0,2,1.000000,0.000000
1000334,qt-labs/qtaddonmimetype,0,2,2,0.000000,1.000000
1000023,qt-labs/qtaddonmimetype,2,0,2,1.000000,0.000000
1000971,qt-labs/qtest-qml,1,0,1,1.000000,0.000000
1000049,qt-labs/qtest-qml,15,5,20,0.750000,0.250000
1002122,qt-labs/qtest-qml,5,2,7,0.714286,0.285714
1000023,qt-labs/qtest-qml,3,0,3,1.000000,0.000000
1000327,qt-labs/qtest-qml,2,1,3,0.666667,0.333333
1000049,qt-labs/qtscriptgenerator,6,2,8,0.750000,0.250000
1000971,qt-labs/qtscriptgenerator,2,2,4,0.500000,0.500000
1000193,qt-labs/qtwebengine,32,39,71,0.450704,0.549296
1000263,qt-labs/qtwebengine,9,3,12,0.750000,0.250000
1000105,qt-labs/qtwebengine,4,3,7,0.571429,0.428571
1002727,qt-labs/qtwebengine,2,0,2,1.000000,0.000000
1002829,qt-labs/qtwebengine,2,0,2,1.000000,0.000000
1002865,qt-labs/qtwebengine,3,2,5,0.600000,0.400000
1000049,qt-labs/qtwebengine,452,209,661,0.683812,0.316188
1000307,qt-labs/qtwebengine,9,14,23,0.391304,0.608696
1000083,qt-labs/qtwebengine,27,20,47,0.574468,0.425532
1000181,qt-labs/qtwebengine,17,23,40,0.425000,0.575000
1001277,qt-labs/qtwebengine,3,2,5,0.600000,0.400000
1000469,qt-labs/qtwebengine,4,0,4,1.000000,0.000000
1000049,qt-labs/qwebchannel,105,121,226,0.464602,0.535398
1000083,qt-labs/qwebchannel,1,4,5,0.200000,0.800000
1000049,qt-labs/umlquick,3,2,5,0.600000,0.400000
1001187,qt-labs/vstools,7,1,8,0.875000,0.125000
1000004,qt-labs/vstools,2,2,4,0.500000,0.500000
1000008,qt-labs/vstools,2,0,2,1.000000,0.000000
1000049,qt-labs/vstools,111,26,137,0.810219,0.189781
1000023,qt-labs/vstools,1,0,1,1.000000,0.000000
1000120,qt-labs/vstools,3,3,6,0.500000,0.500000
1000350,qt-labs/vstools,4,2,6,0.666667,0.333333
1000049,qt-learning/learning-guides,33,17,50,0.660000,0.340000
1000298,qt-learning/learning-guides,8,8,16,0.500000,0.500000
1002116,qt-learning/learning-guides,1,2,3,0.333333,0.666667
1000054,qt-learning/learning-guides,1,0,1,1.000000,0.000000
1000071,qt-learning/learning-guides,3,1,4,0.750000,0.250000
1001984,qt-mobility/qt-mobility,9,8,17,0.529412,0.470588
1000577,qt-mobility/qt-mobility,2,0,2,1.000000,0.000000
1000516,qt-mobility/qt-mobility,6,2,8,0.750000,0.250000
1002374,qt-mobility/qt-mobility,2,0,2,1.000000,0.000000
1000327,qt-mobility/qt-mobility,1,0,1,1.000000,0.000000
1001288,qt-mobility/qt-mobility,0,5,5,0.000000,1.000000
1002122,qt-mobility/qt-mobility,5,0,5,1.000000,0.000000
1001775,qt-mobility/qt-mobility,6,0,6,1.000000,0.000000
1000004,qt-mobility/qt-mobility,2,0,2,1.000000,0.000000
1000049,qt-mobility/qt-mobility,188,86,274,0.686131,0.313869
1001953,qt-mobility/qt-mobility,4,0,4,1.000000,0.000000
1000724,qt-mobility/qt-mobility,2,1,3,0.666667,0.333333
1000661,qt-mobility/qt-mobility,1,3,4,0.250000,0.750000
1000023,qt-mobility/qt-mobility,11,4,15,0.733333,0.266667
1000121,qt-mobility/qt-mobility,5,2,7,0.714286,0.285714
1000762,qt-mobility/qt-mobility,47,25,72,0.652778,0.347222
1002012,qt-mobility/qt-mobility,2,0,2,1.000000,0.000000
1000324,qt-mobility/qt-mobility,4,0,4,1.000000,0.000000
1002176,qt-mobility/qt-mobility,9,2,11,0.818182,0.181818
1000049,qtonpi/mt-cross-tools,13,3,16,0.812500,0.187500
1000577,qtqa/gerrit,2,0,2,1.000000,0.000000
1000130,qtqa/gerrit,6,4,10,0.600000,0.400000
1001187,qtqa/gerrit,2,1,3,0.666667,0.333333
1000004,qtqa/gerrit,18,6,24,0.750000,0.250000
1000971,qtqa/gerrit,6,8,14,0.428571,0.571429
1000049,qtqa/gerrit,19,12,31,0.612903,0.387097
1000023,qtqa/gerrit,7,14,21,0.333333,0.666667
1000063,qtqa/gerrit,1,0,1,1.000000,0.000000
1002401,qtqa/release-testing,2,0,2,1.000000,0.000000
1002377,qtqa/release-testing,2,0,2,1.000000,0.000000
1000971,qtqa/release-testing,2,0,2,1.000000,0.000000
1002221,qtqa/release-testing,2,0,2,1.000000,0.000000
1001454,qtqa/release-testing,2,0,2,1.000000,0.000000
1000049,qtqa/release-testing,8,0,8,1.000000,0.000000
1000578,qtqa/sysadmin,43,24,67,0.641791,0.358209
1002377,qtqa/sysadmin,20,10,30,0.666667,0.333333
1000971,qtqa/sysadmin,116,81,197,0.588832,0.411168
1000592,qtqa/sysadmin,1,2,3,0.333333,0.666667
1000003,qtqa/sysadmin,7,4,11,0.636364,0.363636
1000132,qtqa/sysadmin,1,0,1,1.000000,0.000000
1000098,qtqa/sysadmin,87,29,116,0.750000,0.250000
1002536,qtqa/sysadmin,2,0,2,1.000000,0.000000
1000112,qtqa/sysadmin,2,0,2,1.000000,0.000000
1000129,qtqa/sysadmin,26,32,58,0.448276,0.551724
1000130,qtqa/sysadmin,2,1,3,0.666667,0.333333
1000843,qtqa/sysadmin,1,0,1,1.000000,0.000000
1000004,qtqa/sysadmin,4,3,7,0.571429,0.428571
1000005,qtqa/sysadmin,2,0,2,1.000000,0.000000
1000391,qtqa/sysadmin,3,3,6,0.500000,0.500000
1000014,qtqa/sysadmin,3,1,4,0.750000,0.250000
1000016,qtqa/sysadmin,4,2,6,0.666667,0.333333
1000023,qtqa/sysadmin,67,15,82,0.817073,0.182927
1001949,qtqa/sysadmin,10,13,23,0.434783,0.565217
1001454,qtqa/sysadmin,8,5,13,0.615385,0.384615
1000049,qtqa/sysadmin,837,340,1177,0.711130,0.288870
1000566,qtqa/sysadmin,78,47,125,0.624000,0.376000
1001982,qtqa/sysadmin,3,4,7,0.428571,0.571429
1000063,qtqa/sysadmin,69,56,125,0.552000,0.448000
1000577,qtqa/testconfig,2,0,2,1.000000,0.000000
1000578,qtqa/testconfig,9,5,14,0.642857,0.357143
1000329,qtqa/testconfig,2,0,2,1.000000,0.000000
1000971,qtqa/testconfig,43,39,82,0.524390,0.475610
1000334,qtqa/testconfig,5,4,9,0.555556,0.444444
1000003,qtqa/testconfig,3,4,7,0.428571,0.571429
1000084,qtqa/testconfig,15,3,18,0.833333,0.166667
1002135,qtqa/testconfig,2,0,2,1.000000,0.000000
1000132,qtqa/testconfig,11,5,16,0.687500,0.312500
1000091,qtqa/testconfig,3,3,6,0.500000,0.500000
1000098,qtqa/testconfig,71,36,107,0.663551,0.336449
1000100,qtqa/testconfig,2,0,2,1.000000,0.000000
1000870,qtqa/testconfig,0,1,1,0.000000,1.000000
1000108,qtqa/testconfig,2,1,3,0.666667,0.333333
1000110,qtqa/testconfig,2,1,3,0.666667,0.333333
1000111,qtqa/testconfig,8,1,9,0.888889,0.111111
1000112,qtqa/testconfig,2,3,5,0.400000,0.600000
1002377,qtqa/testconfig,15,4,19,0.789474,0.210526
1000120,qtqa/testconfig,3,2,5,0.600000,0.400000
1000121,qtqa/testconfig,1,0,1,1.000000,0.000000
1000129,qtqa/testconfig,2,1,3,0.666667,0.333333
1000130,qtqa/testconfig,3,2,5,0.600000,0.400000
1000843,qtqa/testconfig,3,0,3,1.000000,0.000000
1000004,qtqa/testconfig,28,8,36,0.777778,0.222222
1000005,qtqa/testconfig,3,0,3,1.000000,0.000000
1000391,qtqa/testconfig,1,0,1,1.000000,0.000000
1000140,qtqa/testconfig,3,1,4,0.750000,0.250000
1000014,qtqa/testconfig,15,2,17,0.882353,0.117647
1000016,qtqa/testconfig,2,2,4,0.500000,0.500000
1000530,qtqa/testconfig,3,1,4,0.750000,0.250000
1000023,qtqa/testconfig,107,63,170,0.629412,0.370588
1001949,qtqa/testconfig,2,4,6,0.333333,0.666667
1000032,qtqa/testconfig,3,3,6,0.500000,0.500000
1000033,qtqa/testconfig,3,0,3,1.000000,0.000000
1000036,qtqa/testconfig,4,5,9,0.444444,0.555556
1001190,qtqa/testconfig,2,0,2,1.000000,0.000000
1002472,qtqa/testconfig,2,3,5,0.400000,0.600000
1000810,qtqa/testconfig,0,1,1,0.000000,1.000000
1001454,qtqa/testconfig,8,5,13,0.615385,0.384615
1000049,qtqa/testconfig,1756,386,2142,0.819795,0.180205
1000181,qtqa/testconfig,3,0,3,1.000000,0.000000
1000566,qtqa/testconfig,25,18,43,0.581395,0.418605
1000312,qtqa/testconfig,4,0,4,1.000000,0.000000
1002749,qtqa/testconfig,2,0,2,1.000000,0.000000
1000063,qtqa/testconfig,39,62,101,0.386139,0.613861
1000004,qt/qlalr,1,2,3,0.333333,0.666667
1000971,qt/qlalr,2,0,2,1.000000,0.000000
1001454,qt/qlalr,2,2,4,0.500000,0.500000
1000015,qt/qlalr,2,0,2,1.000000,0.000000
1000049,qt/qlalr,47,18,65,0.723077,0.276923
1000121,qt/qlalr,2,2,4,0.500000,0.500000
1001984,qt/qt,7,3,10,0.700000,0.300000
1002496,qt/qt,2,0,2,1.000000,0.000000
1000454,qt/qt,3,0,3,1.000000,0.000000
1001991,qt/qt,2,0,2,1.000000,0.000000
1001480,qt/qt,4,2,6,0.666667,0.333333
1000971,qt/qt,58,23,81,0.716049,0.283951
1000973,qt/qt,6,3,9,0.666667,0.333333
1000464,qt/qt,7,1,8,0.875000,0.125000
1000567,qt/qt,2,0,2,1.000000,0.000000
1000478,qt/qt,3,0,3,1.000000,0.000000
1000503,qt/qt,3,0,3,1.000000,0.000000
1002040,qt/qt,1,0,1,1.000000,0.000000
1001966,qt/qt,4,2,6,0.666667,0.333333
1000003,qt/qt,14,10,24,0.583333,0.416667
1000004,qt/qt,147,112,259,0.567568,0.432432
1000005,qt/qt,6,2,8,0.750000,0.250000
1000007,qt/qt,2,0,2,1.000000,0.000000
1001032,qt/qt,22,17,39,0.564103,0.435897
1001143,qt/qt,1,2,3,0.333333,0.666667
1002060,qt/qt,2,0,2,1.000000,0.000000
1000014,qt/qt,48,42,90,0.533333,0.466667
1001039,qt/qt,2,0,2,1.000000,0.000000
1000016,qt/qt,0,1,1,0.000000,1.000000
1001554,qt/qt,6,4,10,0.600000,0.400000
1000532,qt/qt,5,0,5,1.000000,0.000000
1000023,qt/qt,77,51,128,0.601562,0.398438
1000027,qt/qt,4,2,6,0.666667,0.333333
1002588,qt/qt,1,0,1,1.000000,0.000000
1001053,qt/qt,3,3,6,0.500000,0.500000
1000030,qt/qt,5,3,8,0.625000,0.375000
1000032,qt/qt,3,2,5,0.600000,0.400000
1000635,qt/qt,6,2,8,0.750000,0.250000
1000548,qt/qt,34,34,68,0.500000,0.500000
1000037,qt/qt,7,9,16,0.437500,0.562500
1000043,qt/qt,12,6,18,0.666667,0.333333
1000045,qt/qt,4,4,8,0.500000,0.500000
1000558,qt/qt,2,0,2,1.000000,0.000000
1000049,qt/qt,3727,1490,5217,0.714395,0.285605
1000053,qt/qt,2,1,3,0.666667,0.333333
1000566,qt/qt,13,5,18,0.722222,0.277778
1000055,qt/qt,3,4,7,0.428571,0.571429
1000057,qt/qt,1,0,1,1.000000,0.000000
1000127,qt/qt,2,2,4,0.500000,0.500000
1000573,qt/qt,2,0,2,1.000000,0.000000
1000063,qt/qt,23,31,54,0.425926,0.574074
1000064,qt/qt,1,2,3,0.333333,0.666667
1000577,qt/qt,40,11,51,0.784314,0.215686
1001604,qt/qt,8,2,10,0.800000,0.200000
1000070,qt/qt,3,4,7,0.428571,0.571429
1000073,qt/qt,5,1,6,0.833333,0.166667
1002122,qt/qt,8,2,10,0.800000,0.200000
1001100,qt/qt,0,1,1,0.000000,1.000000
1002093,qt/qt,8,7,15,0.533333,0.466667
1000592,qt/qt,16,16,32,0.500000,0.500000
1002641,qt/qt,10,0,10,1.000000,0.000000
1000084,qt/qt,9,11,20,0.450000,0.550000
1002133,qt/qt,1,0,1,1.000000,0.000000
1002136,qt/qt,2,2,4,0.500000,0.500000
1001156,qt/qt,12,8,20,0.600000,0.400000
1000090,qt/qt,1,0,1,1.000000,0.000000
1000091,qt/qt,3,3,6,0.500000,0.500000
1000092,qt/qt,2,1,3,0.666667,0.333333
1000093,qt/qt,39,32,71,0.549296,0.450704
1002142,qt/qt,4,0,4,1.000000,0.000000
1002144,qt/qt,4,2,6,0.666667,0.333333
1002145,qt/qt,2,1,3,0.666667,0.333333
1000098,qt/qt,97,17,114,0.850877,0.149123
1000611,qt/qt,2,0,2,1.000000,0.000000
1000100,qt/qt,13,14,27,0.481481,0.518519
1000101,qt/qt,10,6,16,0.625000,0.375000
1000105,qt/qt,8,2,10,0.800000,0.200000
1001130,qt/qt,4,3,7,0.571429,0.428571
1000108,qt/qt,3,2,5,0.600000,0.400000
1001133,qt/qt,7,7,14,0.500000,0.500000
1002160,qt/qt,2,1,3,0.666667,0.333333
1002676,qt/qt,1,0,1,1.000000,0.000000
1001141,qt/qt,1,1,2,0.500000,0.500000
1000119,qt/qt,2,0,2,1.000000,0.000000
1000120,qt/qt,7,6,13,0.538462,0.461538
1000121,qt/qt,34,20,54,0.629630,0.370370
1000123,qt/qt,6,10,16,0.375000,0.625000
1000124,qt/qt,4,8,12,0.333333,0.666667
1000125,qt/qt,1,2,3,0.333333,0.666667
1000565,qt/qt,29,11,40,0.725000,0.275000
1002176,qt/qt,8,4,12,0.666667,0.333333
1000129,qt/qt,6,7,13,0.461538,0.538462
1000130,qt/qt,9,5,14,0.642857,0.357143
1000132,qt/qt,4,2,6,0.666667,0.333333
1000054,qt/qt,12,5,17,0.705882,0.294118
1001163,qt/qt,10,1,11,0.909091,0.090909
1000140,qt/qt,2,0,2,1.000000,0.000000
1000330,qt/qt,4,4,8,0.500000,0.500000
1000661,qt/qt,110,50,160,0.687500,0.312500
1000150,qt/qt,7,3,10,0.700000,0.300000
1000153,qt/qt,7,2,9,0.777778,0.222222
1000666,qt/qt,7,4,11,0.636364,0.363636
1000155,qt/qt,16,7,23,0.695652,0.304348
1002207,qt/qt,2,0,2,1.000000,0.000000
1001697,qt/qt,4,1,5,0.800000,0.200000
1001186,qt/qt,2,0,2,1.000000,0.000000
1000163,qt/qt,3,0,3,1.000000,0.000000
1000164,qt/qt,2,0,2,1.000000,0.000000
1000166,qt/qt,2,0,2,1.000000,0.000000
1000681,qt/qt,72,2,74,0.972973,0.027027
1002730,qt/qt,2,1,3,0.666667,0.333333
1000171,qt/qt,2,2,4,0.500000,0.500000
1001198,qt/qt,4,0,4,1.000000,0.000000
1002223,qt/qt,2,1,3,0.666667,0.333333
1002225,qt/qt,2,0,2,1.000000,0.000000
1002232,qt/qt,2,1,3,0.666667,0.333333
1000185,qt/qt,4,3,7,0.571429,0.428571
1001211,qt/qt,61,4,65,0.938462,0.061538
1001212,qt/qt,2,0,2,1.000000,0.000000
1001190,qt/qt,2,1,3,0.666667,0.333333
1000708,qt/qt,7,7,14,0.500000,0.500000
1000199,qt/qt,3,2,5,0.600000,0.400000
1000203,qt/qt,4,2,6,0.666667,0.333333
1001740,qt/qt,4,2,6,0.666667,0.333333
1002255,qt/qt,1,0,1,1.000000,0.000000
1001237,qt/qt,4,1,5,0.800000,0.200000
1002713,qt/qt,3,1,4,0.750000,0.250000
1001239,qt/qt,2,2,4,0.500000,0.500000
1001240,qt/qt,0,2,2,0.000000,1.000000
1002116,qt/qt,13,2,15,0.866667,0.133333
1001246,qt/qt,17,3,20,0.850000,0.150000
1002272,qt/qt,27,2,29,0.931034,0.068966
1000738,qt/qt,6,2,8,0.750000,0.250000
1001764,qt/qt,2,2,4,0.500000,0.500000
1000230,qt/qt,10,7,17,0.588235,0.411765
1000231,qt/qt,11,3,14,0.785714,0.214286
1000746,qt/qt,2,1,3,0.666667,0.333333
1000750,qt/qt,4,1,5,0.800000,0.200000
1001775,qt/qt,24,2,26,0.923077,0.076923
1002376,qt/qt,2,0,2,1.000000,0.000000
1002645,qt/qt,2,2,4,0.500000,0.500000
1002377,qt/qt,8,0,8,1.000000,0.000000
1000762,qt/qt,92,35,127,0.724409,0.275591
1000074,qt/qt,5,3,8,0.625000,0.375000
1000843,qt/qt,2,0,2,1.000000,0.000000
1001796,qt/qt,1,3,4,0.250000,0.750000
1001288,qt/qt,77,39,116,0.663793,0.336207
1000271,qt/qt,1,2,3,0.333333,0.666667
1002320,qt/qt,2,0,2,1.000000,0.000000
1002321,qt/qt,8,5,13,0.615385,0.384615
1002146,qt/qt,2,1,3,0.666667,0.333333
1002341,qt/qt,0,2,2,0.000000,1.000000
1000298,qt/qt,8,0,8,1.000000,0.000000
1000868,qt/qt,3,0,3,1.000000,0.000000
1001277,qt/qt,2,0,2,1.000000,0.000000
1001857,qt/qt,6,0,6,1.000000,0.000000
1000822,qt/qt,29,7,36,0.805556,0.194444
1000312,qt/qt,18,7,25,0.720000,0.280000
1000357,qt/qt,2,1,3,0.666667,0.333333
1001340,qt/qt,2,0,2,1.000000,0.000000
1000831,qt/qt,7,3,10,0.700000,0.300000
1000833,qt/qt,23,20,43,0.534884,0.465116
1001195,qt/qt,2,0,2,1.000000,0.000000
1000327,qt/qt,49,32,81,0.604938,0.395062
1000328,qt/qt,14,11,25,0.560000,0.440000
1000329,qt/qt,169,158,327,0.516820,0.483180
1001892,qt/qt,2,1,3,0.666667,0.333333
1000331,qt/qt,10,5,15,0.666667,0.333333
1000844,qt/qt,35,3,38,0.921053,0.078947
1000334,qt/qt,10,7,17,0.588235,0.411765
1000335,qt/qt,2,0,2,1.000000,0.000000
1000085,qt/qt,12,17,29,0.413793,0.586207
1000338,qt/qt,100,42,142,0.704225,0.295775
1002051,qt/qt,2,3,5,0.400000,0.600000
1000340,qt/qt,5,0,5,1.000000,0.000000
1001454,qt/qt,16,3,19,0.842105,0.157895
1002137,qt/qt,2,2,4,0.500000,0.500000
1000856,qt/qt,4,0,4,1.000000,0.000000
1000516,qt/qt,2,0,2,1.000000,0.000000
1002138,qt/qt,2,2,4,0.500000,0.500000
1000350,qt/qt,4,3,7,0.571429,0.428571
1000351,qt/qt,12,5,17,0.705882,0.294118
1000354,qt/qt,5,2,7,0.714286,0.285714
1001380,qt/qt,84,28,112,0.750000,0.250000
1000869,qt/qt,34,21,55,0.618182,0.381818
1001895,qt/qt,2,0,2,1.000000,0.000000
1001387,qt/qt,12,0,12,1.000000,0.000000
1000876,qt/qt,2,0,2,1.000000,0.000000
1000365,qt/qt,2,0,2,1.000000,0.000000
1000382,qt/qt,1,2,3,0.333333,0.666667
1000387,qt/qt,2,1,3,0.666667,0.333333
1000901,qt/qt,60,22,82,0.731707,0.268293
1000391,qt/qt,8,6,14,0.571429,0.428571
1000341,qt/qt,12,8,20,0.600000,0.400000
1001931,qt/qt,2,1,3,0.666667,0.333333
1000610,qt/qt,5,2,7,0.714286,0.285714
1000912,qt/qt,1,1,2,0.500000,0.500000
1000402,qt/qt,2,0,2,1.000000,0.000000
1001942,qt/qt,2,2,4,0.500000,0.500000
1001943,qt/qt,0,1,1,0.000000,1.000000
1001945,qt/qt,2,0,2,1.000000,0.000000
1000410,qt/qt,19,11,30,0.633333,0.366667
1000413,qt/qt,2,0,2,1.000000,0.000000
1002149,qt/qt,2,1,3,0.666667,0.333333
1000207,qt/qt,1,0,1,1.000000,0.000000
1002219,qt/qt,10,7,17,0.588235,0.411765
1000530,qt/qt,7,3,10,0.700000,0.300000
1000942,qt/qt,0,1,1,0.000000,1.000000
1001967,qt/qt,1,0,1,1.000000,0.000000
1000944,qt/qt,2,0,2,1.000000,0.000000
1001973,qt/qt,4,0,4,1.000000,0.000000
1001556,qt/qt,0,2,2,0.000000,1.000000
1000106,qt/qt,2,0,2,1.000000,0.000000
1001982,qt/qt,1,1,2,0.500000,0.500000
1000194,qt/qt3d,35,15,50,0.700000,0.300000
1000835,qt/qt3d,52,14,66,0.787879,0.212121
1000198,qt/qt3d,19,6,25,0.760000,0.240000
1002360,qt/qt3d,3,0,3,1.000000,0.000000
1000329,qt/qt3d,8,8,16,0.500000,0.500000
1000971,qt/qt3d,2,5,7,0.285714,0.714286
1002006,qt/qt3d,10,6,16,0.625000,0.375000
1002097,qt/qt3d,0,2,2,0.000000,1.000000
1002289,qt/qt3d,2,0,2,1.000000,0.000000
1000869,qt/qt3d,2,0,2,1.000000,0.000000
1002150,qt/qt3d,2,1,3,0.666667,0.333333
1000359,qt/qt3d,1,0,1,1.000000,0.000000
1001133,qt/qt3d,18,10,28,0.642857,0.357143
1000881,qt/qt3d,8,3,11,0.727273,0.272727
1001143,qt/qt3d,1,2,3,0.333333,0.666667
1000120,qt/qt3d,1,0,1,1.000000,0.000000
1000121,qt/qt3d,8,7,15,0.533333,0.466667
1002042,qt/qt3d,6,0,6,1.000000,0.000000
1000124,qt/qt3d,0,1,1,0.000000,1.000000
1000010,qt/qt3d,4,0,4,1.000000,0.000000
1000004,qt/qt3d,16,13,29,0.551724,0.448276
1002054,qt/qt3d,6,5,11,0.545455,0.454545
1000023,qt/qt3d,8,3,11,0.727273,0.272727
1000503,qt/qt3d,2,2,4,0.500000,0.500000
1000012,qt/qt3d,1,2,3,0.333333,0.666667
1000014,qt/qt3d,2,1,3,0.666667,0.333333
1000016,qt/qt3d,4,4,8,0.500000,0.500000
1001912,qt/qt3d,0,1,1,0.000000,1.000000
1001682,qt/qt3d,2,0,2,1.000000,0.000000
1000661,qt/qt3d,16,12,28,0.571429,0.428571
1000070,qt/qt3d,2,0,2,1.000000,0.000000
1000030,qt/qt3d,5,3,8,0.625000,0.375000
1000164,qt/qt3d,2,0,2,1.000000,0.000000
1000166,qt/qt3d,2,0,2,1.000000,0.000000
1000934,qt/qt3d,2,0,2,1.000000,0.000000
1000298,qt/qt3d,2,0,2,1.000000,0.000000
1000171,qt/qt3d,29,10,39,0.743590,0.256410
1001967,qt/qt3d,2,0,2,1.000000,0.000000
1000176,qt/qt3d,2,2,4,0.500000,0.500000
1000049,qt/qt3d,927,346,1273,0.728201,0.271799
1000179,qt/qt3d,12,10,22,0.545455,0.454545
1000312,qt/qt3d,20,3,23,0.869565,0.130435
1000063,qt/qt3d,7,7,14,0.500000,0.500000
1000064,qt/qt5,2,2,4,0.500000,0.500000
1001984,qt/qt5,2,2,4,0.500000,0.500000
1000327,qt/qt5,4,0,4,1.000000,0.000000
1000329,qt/qt5,12,7,19,0.631579,0.368421
1000971,qt/qt5,3,1,4,0.750000,0.250000
1000334,qt/qt5,5,3,8,0.625000,0.375000
1000592,qt/qt5,4,5,9,0.444444,0.555556
1000084,qt/qt5,49,22,71,0.690141,0.309859
1001877,qt/qt5,3,3,6,0.500000,0.500000
1002006,qt/qt5,0,2,2,0.000000,1.000000
1002820,qt/qt5,2,0,2,1.000000,0.000000
1000861,qt/qt5,7,2,9,0.777778,0.222222
1000097,qt/qt5,2,2,4,0.500000,0.500000
1000098,qt/qt5,9,6,15,0.600000,0.400000
1000229,qt/qt5,1,0,1,1.000000,0.000000
1000359,qt/qt5,9,6,15,0.600000,0.400000
1000110,qt/qt5,2,3,5,0.400000,0.600000
1002377,qt/qt5,5,2,7,0.714286,0.285714
1000120,qt/qt5,4,4,8,0.500000,0.500000
1000121,qt/qt5,27,12,39,0.692308,0.307692
1000577,qt/qt5,2,0,2,1.000000,0.000000
1000124,qt/qt5,1,0,1,1.000000,0.000000
1002176,qt/qt5,3,1,4,0.750000,0.250000
1000129,qt/qt5,0,2,2,0.000000,1.000000
1000130,qt/qt5,2,0,2,1.000000,0.000000
1000003,qt/qt5,10,6,16,0.625000,0.375000
1000004,qt/qt5,41,22,63,0.650794,0.349206
1000005,qt/qt5,11,7,18,0.611111,0.388889
1000136,qt/qt5,2,2,4,0.500000,0.500000
1000014,qt/qt5,5,0,5,1.000000,0.000000
1000143,qt/qt5,3,0,3,1.000000,0.000000
1000016,qt/qt5,11,10,21,0.523810,0.476190
1000023,qt/qt5,244,114,358,0.681564,0.318436
1000666,qt/qt5,1,0,1,1.000000,0.000000
1000015,qt/qt5,0,1,1,0.000000,1.000000
1000101,qt/qt5,1,0,1,1.000000,0.000000
1000548,qt/qt5,36,37,73,0.493151,0.506849
1002472,qt/qt5,9,6,15,0.600000,0.400000
1000041,qt/qt5,2,0,2,1.000000,0.000000
1000043,qt/qt5,1,1,2,0.500000,0.500000
1000331,qt/qt5,6,4,10,0.600000,0.400000
1001454,qt/qt5,2,0,2,1.000000,0.000000
1001967,qt/qt5,5,4,9,0.555556,0.444444
1000049,qt/qt5,2372,2155,4527,0.523967,0.476033
1000566,qt/qt5,4,2,6,0.666667,0.333333
1000312,qt/qt5,8,5,13,0.615385,0.384615
1000340,qt/qt5,3,0,3,1.000000,0.000000
1000186,qt/qt5,2,0,2,1.000000,0.000000
1001982,qt/qt5,2,1,3,0.666667,0.333333
1000063,qt/qt5,125,105,230,0.543478,0.456522
1000577,qt/qtactiveqt,6,0,6,1.000000,0.000000
1000329,qt/qtactiveqt,7,2,9,0.777778,0.222222
1000971,qt/qtactiveqt,3,3,6,0.500000,0.500000
1000334,qt/qtactiveqt,2,0,2,1.000000,0.000000
1000592,qt/qtactiveqt,3,6,9,0.333333,0.666667
1000338,qt/qtactiveqt,5,8,13,0.384615,0.615385
1000091,qt/qtactiveqt,2,1,3,0.666667,0.333333
1000355,qt/qtactiveqt,7,6,13,0.538462,0.461538
1000100,qt/qtactiveqt,2,0,2,1.000000,0.000000
1000101,qt/qtactiveqt,4,3,7,0.571429,0.428571
1002150,qt/qtactiveqt,1,2,3,0.333333,0.666667
1000120,qt/qtactiveqt,7,7,14,0.500000,0.500000
1000121,qt/qtactiveqt,4,1,5,0.800000,0.200000
1001931,qt/qtactiveqt,2,0,2,1.000000,0.000000
1000004,qt/qtactiveqt,19,13,32,0.593750,0.406250
1000822,qt/qtactiveqt,15,6,21,0.714286,0.285714
1000391,qt/qtactiveqt,4,1,5,0.800000,0.200000
1001419,qt/qtactiveqt,3,0,3,1.000000,0.000000
1000013,qt/qtactiveqt,2,0,2,1.000000,0.000000
1000014,qt/qtactiveqt,26,23,49,0.530612,0.469388
1000015,qt/qtactiveqt,5,6,11,0.454545,0.545455
1000661,qt/qtactiveqt,2,0,2,1.000000,0.000000
1000023,qt/qtactiveqt,5,0,5,1.000000,0.000000
1000026,qt/qtactiveqt,1,2,3,0.333333,0.666667
1000681,qt/qtactiveqt,1,0,1,1.000000,0.000000
1000298,qt/qtactiveqt,4,0,4,1.000000,0.000000
1001454,qt/qtactiveqt,2,0,2,1.000000,0.000000
1000049,qt/qtactiveqt,427,147,574,0.743902,0.256098
1000054,qt/qtactiveqt,8,7,15,0.533333,0.466667
1000312,qt/qtactiveqt,4,0,4,1.000000,0.000000
1001982,qt/qtactiveqt,2,0,2,1.000000,0.000000
1000132,qt/qtandroidextras,1,2,3,0.333333,0.666667
1000074,qt/qtandroidextras,1,0,1,1.000000,0.000000
1001419,qt/qtandroidextras,5,0,5,1.000000,0.000000
1000049,qt/qtandroidextras,48,22,70,0.685714,0.314286
1000530,qt/qtandroidextras,2,0,2,1.000000,0.000000
1000023,qt/qtandroidextras,1,0,1,1.000000,0.000000
1000298,qt/qtandroidextras,2,0,2,1.000000,0.000000
1002496,qt/qtbase,2,0,2,1.000000,0.000000
1001480,qt/qtbase,4,6,10,0.400000,0.600000
1002160,qt/qtbase,13,9,22,0.590909,0.409091
1001516,qt/qtbase,1,0,1,1.000000,0.000000
1001530,qt/qtbase,2,1,3,0.666667,0.333333
1001549,qt/qtbase,2,6,8,0.250000,0.750000
1001554,qt/qtbase,3,2,5,0.600000,0.400000
1000121,qt/qtbase,1016,793,1809,0.561636,0.438364
1001572,qt/qtbase,38,34,72,0.527778,0.472222
1002172,qt/qtbase,1,0,1,1.000000,0.000000
1000128,qt/qtbase,3,0,3,1.000000,0.000000
1001623,qt/qtbase,14,5,19,0.736842,0.263158
1002180,qt/qtbase,3,0,3,1.000000,0.000000
1001653,qt/qtbase,8,0,8,1.000000,0.000000
1001656,qt/qtbase,3,2,5,0.600000,0.400000
1001661,qt/qtbase,2,0,2,1.000000,0.000000
1001505,qt/qtbase,2,1,3,0.666667,0.333333
1001692,qt/qtbase,3,0,3,1.000000,0.000000
1002192,qt/qtbase,14,2,16,0.875000,0.125000
1001740,qt/qtbase,13,11,24,0.541667,0.458333
1001746,qt/qtbase,17,8,25,0.680000,0.320000
1001764,qt/qtbase,2,6,8,0.250000,0.750000
1001768,qt/qtbase,12,15,27,0.444444,0.555556
1001775,qt/qtbase,71,34,105,0.676190,0.323810
1001796,qt/qtbase,24,5,29,0.827586,0.172414
1002211,qt/qtbase,2,0,2,1.000000,0.000000
1001854,qt/qtbase,0,2,2,0.000000,1.000000
1001857,qt/qtbase,85,68,153,0.555556,0.444444
1002219,qt/qtbase,6,3,9,0.666667,0.333333
1001871,qt/qtbase,2,0,2,1.000000,0.000000
1001892,qt/qtbase,2,1,3,0.666667,0.333333
1001896,qt/qtbase,2,0,2,1.000000,0.000000
1001911,qt/qtbase,7,12,19,0.368421,0.631579
1001931,qt/qtbase,99,98,197,0.502538,0.497462
1001942,qt/qtbase,0,1,1,0.000000,1.000000
1002233,qt/qtbase,1,0,1,1.000000,0.000000
1001953,qt/qtbase,2,1,3,0.666667,0.333333
1001962,qt/qtbase,0,2,2,0.000000,1.000000
1001963,qt/qtbase,2,0,2,1.000000,0.000000
1001967,qt/qtbase,218,157,375,0.581333,0.418667
1001973,qt/qtbase,4,0,4,1.000000,0.000000
1001975,qt/qtbase,47,12,59,0.796610,0.203390
1001982,qt/qtbase,4,2,6,0.666667,0.333333
1001984,qt/qtbase,5,2,7,0.714286,0.285714
1001987,qt/qtbase,4,0,4,1.000000,0.000000
1002000,qt/qtbase,2,0,2,1.000000,0.000000
1002006,qt/qtbase,2,1,3,0.666667,0.333333
1002021,qt/qtbase,1,0,1,1.000000,0.000000
1002040,qt/qtbase,4,0,4,1.000000,0.000000
1002050,qt/qtbase,6,1,7,0.857143,0.142857
1000003,qt/qtbase,236,124,360,0.655556,0.344444
1000004,qt/qtbase,3295,1823,5118,0.643806,0.356194
1000005,qt/qtbase,99,71,170,0.582353,0.417647
1002054,qt/qtbase,26,22,48,0.541667,0.458333
1000007,qt/qtbase,35,26,61,0.573770,0.426230
1000008,qt/qtbase,187,128,315,0.593651,0.406349
1000009,qt/qtbase,5,3,8,0.625000,0.375000
1000010,qt/qtbase,18,8,26,0.692308,0.307692
1000011,qt/qtbase,22,6,28,0.785714,0.214286
1000012,qt/qtbase,3,0,3,1.000000,0.000000
1000013,qt/qtbase,37,9,46,0.804348,0.195652
1000014,qt/qtbase,1772,1020,2792,0.634670,0.365330
1000015,qt/qtbase,147,60,207,0.710145,0.289855
1000016,qt/qtbase,23,16,39,0.589744,0.410256
1000019,qt/qtbase,2,1,3,0.666667,0.333333
1000023,qt/qtbase,308,143,451,0.682927,0.317073
1000024,qt/qtbase,9,5,14,0.642857,0.357143
1000025,qt/qtbase,4,2,6,0.666667,0.333333
1000026,qt/qtbase,35,29,64,0.546875,0.453125
1000027,qt/qtbase,18,12,30,0.600000,0.400000
1000032,qt/qtbase,223,159,382,0.583770,0.416230
1000033,qt/qtbase,5,2,7,0.714286,0.285714
1000034,qt/qtbase,20,6,26,0.769231,0.230769
1000035,qt/qtbase,20,7,27,0.740741,0.259259
1000036,qt/qtbase,154,105,259,0.594595,0.405405
1000037,qt/qtbase,66,51,117,0.564103,0.435897
1002086,qt/qtbase,3,1,4,0.750000,0.250000
1000039,qt/qtbase,0,1,1,0.000000,1.000000
1000041,qt/qtbase,2,1,3,0.666667,0.333333
1000042,qt/qtbase,2,0,2,1.000000,0.000000
1000043,qt/qtbase,232,214,446,0.520179,0.479821
1000044,qt/qtbase,7,7,14,0.500000,0.500000
1000045,qt/qtbase,259,167,426,0.607981,0.392019
1002095,qt/qtbase,1,0,1,1.000000,0.000000
1000049,qt/qtbase,38207,23233,61440,0.621859,0.378141
1000050,qt/qtbase,7,3,10,0.700000,0.300000
1000052,qt/qtbase,13,13,26,0.500000,0.500000
1000053,qt/qtbase,61,44,105,0.580952,0.419048
1000054,qt/qtbase,193,123,316,0.610759,0.389241
1000055,qt/qtbase,52,35,87,0.597701,0.402299
1000056,qt/qtbase,2,0,2,1.000000,0.000000
1002596,qt/qtbase,3,3,6,0.500000,0.500000
1000061,qt/qtbase,4,1,5,0.800000,0.200000
1000063,qt/qtbase,638,576,1214,0.525535,0.474465
1000064,qt/qtbase,9,6,15,0.600000,0.400000
1000065,qt/qtbase,29,31,60,0.483333,0.516667
1000068,qt/qtbase,37,30,67,0.552239,0.447761
1000070,qt/qtbase,236,211,447,0.527964,0.472036
1000071,qt/qtbase,22,15,37,0.594595,0.405405
1000073,qt/qtbase,16,15,31,0.516129,0.483871
1000074,qt/qtbase,8,5,13,0.615385,0.384615
1000075,qt/qtbase,27,19,46,0.586957,0.413043
1000076,qt/qtbase,3,1,4,0.750000,0.250000
1000077,qt/qtbase,50,50,100,0.500000,0.500000
1000078,qt/qtbase,6,6,12,0.500000,0.500000
1000079,qt/qtbase,4,2,6,0.666667,0.333333
1000082,qt/qtbase,4,2,6,0.666667,0.333333
1000083,qt/qtbase,27,16,43,0.627907,0.372093
1000084,qt/qtbase,37,24,61,0.606557,0.393443
1000085,qt/qtbase,81,69,150,0.540000,0.460000
1000086,qt/qtbase,3,3,6,0.500000,0.500000
1000087,qt/qtbase,2,1,3,0.666667,0.333333
1002137,qt/qtbase,10,10,20,0.500000,0.500000
1000090,qt/qtbase,16,18,34,0.470588,0.529412
1000091,qt/qtbase,447,267,714,0.626050,0.373950
1000092,qt/qtbase,83,50,133,0.624060,0.375940
1000093,qt/qtbase,193,173,366,0.527322,0.472678
1002142,qt/qtbase,6,6,12,0.500000,0.500000
1000096,qt/qtbase,7,5,12,0.583333,0.416667
1000097,qt/qtbase,36,13,49,0.734694,0.265306
1000098,qt/qtbase,38,12,50,0.760000,0.240000
1000100,qt/qtbase,299,234,533,0.560976,0.439024
1000101,qt/qtbase,298,179,477,0.624738,0.375262
1002150,qt/qtbase,19,20,39,0.487179,0.512821
1000104,qt/qtbase,7,2,9,0.777778,0.222222
1000105,qt/qtbase,240,217,457,0.525164,0.474836
1000106,qt/qtbase,2,3,5,0.400000,0.600000
1000108,qt/qtbase,179,152,331,0.540785,0.459215
1000109,qt/qtbase,2,0,2,1.000000,0.000000
1000110,qt/qtbase,208,94,302,0.688742,0.311258
1000111,qt/qtbase,3,0,3,1.000000,0.000000
1000112,qt/qtbase,2,0,2,1.000000,0.000000
1002161,qt/qtbase,3,1,4,0.750000,0.250000
1000116,qt/qtbase,2,0,2,1.000000,0.000000
1000118,qt/qtbase,13,1,14,0.928571,0.071429
1000119,qt/qtbase,12,6,18,0.666667,0.333333
1000120,qt/qtbase,509,254,763,0.667104,0.332896
1002169,qt/qtbase,2001,952,2953,0.677616,0.322384
1000122,qt/qtbase,3,2,5,0.600000,0.400000
1000123,qt/qtbase,49,60,109,0.449541,0.550459
1000124,qt/qtbase,101,81,182,0.554945,0.445055
1000125,qt/qtbase,3,0,3,1.000000,0.000000
1000126,qt/qtbase,32,26,58,0.551724,0.448276
1000127,qt/qtbase,66,43,109,0.605505,0.394495
1002176,qt/qtbase,65,20,85,0.764706,0.235294
1000129,qt/qtbase,17,7,24,0.708333,0.291667
1000130,qt/qtbase,440,251,691,0.636758,0.363242
1000131,qt/qtbase,12,5,17,0.705882,0.294118
1000132,qt/qtbase,306,235,541,0.565619,0.434381
1000133,qt/qtbase,5,11,16,0.312500,0.687500
1002182,qt/qtbase,2,0,2,1.000000,0.000000
1002184,qt/qtbase,2,0,2,1.000000,0.000000
1000138,qt/qtbase,20,17,37,0.540541,0.459459
1000140,qt/qtbase,225,132,357,0.630252,0.369748
1000141,qt/qtbase,8,0,8,1.000000,0.000000
1002191,qt/qtbase,1,0,1,1.000000,0.000000
1000144,qt/qtbase,2,1,3,0.666667,0.333333
1000145,qt/qtbase,2,1,3,0.666667,0.333333
1000146,qt/qtbase,32,2,34,0.941176,0.058824
1000147,qt/qtbase,19,18,37,0.513514,0.486486
1002197,qt/qtbase,5,2,7,0.714286,0.285714
1000150,qt/qtbase,2,2,4,0.500000,0.500000
1000152,qt/qtbase,13,0,13,1.000000,0.000000
1000153,qt/qtbase,24,12,36,0.666667,0.333333
1000155,qt/qtbase,618,511,1129,0.547387,0.452613
1002204,qt/qtbase,6,4,10,0.600000,0.400000
1000158,qt/qtbase,1,3,4,0.250000,0.750000
1000160,qt/qtbase,3,0,3,1.000000,0.000000
1000163,qt/qtbase,67,71,138,0.485507,0.514493
1000164,qt/qtbase,6,5,11,0.545455,0.454545
1000166,qt/qtbase,40,36,76,0.526316,0.473684
1002215,qt/qtbase,4,0,4,1.000000,0.000000
1000171,qt/qtbase,2,0,2,1.000000,0.000000
1000172,qt/qtbase,22,20,42,0.523810,0.476190
1000173,qt/qtbase,2,1,3,0.666667,0.333333
1002223,qt/qtbase,4,3,7,0.571429,0.428571
1000181,qt/qtbase,12,1,13,0.923077,0.076923
1002232,qt/qtbase,6,3,9,0.666667,0.333333
1000185,qt/qtbase,7,4,11,0.636364,0.363636
1000190,qt/qtbase,3,1,4,0.750000,0.250000
1000193,qt/qtbase,8,8,16,0.500000,0.500000
1000198,qt/qtbase,3,5,8,0.375000,0.625000
1000199,qt/qtbase,3,0,3,1.000000,0.000000
1000203,qt/qtbase,62,35,97,0.639175,0.360825
1000205,qt/qtbase,7,4,11,0.636364,0.363636
1000207,qt/qtbase,88,29,117,0.752137,0.247863
1000211,qt/qtbase,2,1,3,0.666667,0.333333
1002286,qt/qtbase,2,0,2,1.000000,0.000000
1000214,qt/qtbase,10,5,15,0.666667,0.333333
1002272,qt/qtbase,16,11,27,0.592593,0.407407
1002280,qt/qtbase,6,8,14,0.428571,0.571429
1002282,qt/qtbase,9,5,14,0.642857,0.357143
1002283,qt/qtbase,2,2,4,0.500000,0.500000
1000238,qt/qtbase,2,0,2,1.000000,0.000000
1002289,qt/qtbase,28,9,37,0.756757,0.243243
1002292,qt/qtbase,3,3,6,0.500000,0.500000
1002295,qt/qtbase,1,0,1,1.000000,0.000000
1000259,qt/qtbase,2,0,2,1.000000,0.000000
1000261,qt/qtbase,3,0,3,1.000000,0.000000
1002310,qt/qtbase,2,0,2,1.000000,0.000000
1000264,qt/qtbase,4,1,5,0.800000,0.200000
1000270,qt/qtbase,57,25,82,0.695122,0.304878
1000271,qt/qtbase,24,14,38,0.631579,0.368421
1002321,qt/qtbase,15,3,18,0.833333,0.166667
1000274,qt/qtbase,28,9,37,0.756757,0.243243
1002332,qt/qtbase,5,3,8,0.625000,0.375000
1002336,qt/qtbase,6,2,8,0.750000,0.250000
1002341,qt/qtbase,2,8,10,0.200000,0.800000
1000295,qt/qtbase,3,1,4,0.750000,0.250000
1000298,qt/qtbase,154,78,232,0.663793,0.336207
1000307,qt/qtbase,5,3,8,0.625000,0.375000
1000308,qt/qtbase,3,2,5,0.600000,0.400000
1002359,qt/qtbase,6,3,9,0.666667,0.333333
1000312,qt/qtbase,202,89,291,0.694158,0.305842
1002369,qt/qtbase,3,0,3,1.000000,0.000000
1000322,qt/qtbase,1,0,1,1.000000,0.000000
1000323,qt/qtbase,6,3,9,0.666667,0.333333
1000324,qt/qtbase,46,35,81,0.567901,0.432099
1002374,qt/qtbase,7,4,11,0.636364,0.363636
1000327,qt/qtbase,634,338,972,0.652263,0.347737
1000328,qt/qtbase,946,603,1549,0.610717,0.389283
1000329,qt/qtbase,2874,2073,4947,0.580958,0.419042
1000331,qt/qtbase,154,94,248,0.620968,0.379032
1000334,qt/qtbase,567,349,916,0.618996,0.381004
1000335,qt/qtbase,4,2,6,0.666667,0.333333
1000338,qt/qtbase,369,211,580,0.636207,0.363793
1000340,qt/qtbase,9,6,15,0.600000,0.400000
1000341,qt/qtbase,19,3,22,0.863636,0.136364
1000343,qt/qtbase,2,2,4,0.500000,0.500000
1002392,qt/qtbase,4,0,4,1.000000,0.000000
1000350,qt/qtbase,4,0,4,1.000000,0.000000
1000351,qt/qtbase,70,38,108,0.648148,0.351852
1000354,qt/qtbase,51,14,65,0.784615,0.215385
1000357,qt/qtbase,5,3,8,0.625000,0.375000
1000359,qt/qtbase,31,33,64,0.484375,0.515625
1000365,qt/qtbase,2,0,2,1.000000,0.000000
1002416,qt/qtbase,5,1,6,0.833333,0.166667
1000382,qt/qtbase,55,32,87,0.632184,0.367816
1000386,qt/qtbase,0,9,9,0.000000,1.000000
1002435,qt/qtbase,4,1,5,0.800000,0.200000
1000391,qt/qtbase,79,33,112,0.705357,0.294643
1000398,qt/qtbase,4,3,7,0.571429,0.428571
1000402,qt/qtbase,10,1,11,0.909091,0.090909
1002451,qt/qtbase,3,0,3,1.000000,0.000000
1000405,qt/qtbase,15,6,21,0.714286,0.285714
1000409,qt/qtbase,1,0,1,1.000000,0.000000
1000410,qt/qtbase,46,24,70,0.657143,0.342857
1000413,qt/qtbase,5,1,6,0.833333,0.166667
1002472,qt/qtbase,9,0,9,1.000000,0.000000
1000426,qt/qtbase,2,0,2,1.000000,0.000000
1000427,qt/qtbase,1,0,1,1.000000,0.000000
1002477,qt/qtbase,1,1,2,0.500000,0.500000
1000431,qt/qtbase,14,10,24,0.583333,0.416667
1000433,qt/qtbase,10,6,16,0.625000,0.375000
1000443,qt/qtbase,3,1,4,0.750000,0.250000
1000446,qt/qtbase,2,0,2,1.000000,0.000000
1000448,qt/qtbase,74,53,127,0.582677,0.417323
1000455,qt/qtbase,2,0,2,1.000000,0.000000
1000456,qt/qtbase,5,2,7,0.714286,0.285714
1002505,qt/qtbase,7,2,9,0.777778,0.222222
1000463,qt/qtbase,2,1,3,0.666667,0.333333
1000464,qt/qtbase,153,143,296,0.516892,0.483108
1000472,qt/qtbase,4,0,4,1.000000,0.000000
1000480,qt/qtbase,2,0,2,1.000000,0.000000
1000481,qt/qtbase,2,0,2,1.000000,0.000000
1002536,qt/qtbase,1,1,2,0.500000,0.500000
1000496,qt/qtbase,2,1,3,0.666667,0.333333
1002549,qt/qtbase,0,1,1,0.000000,1.000000
1000503,qt/qtbase,32,29,61,0.524590,0.475410
1002553,qt/qtbase,2,0,2,1.000000,0.000000
1000516,qt/qtbase,35,11,46,0.760870,0.239130
1000521,qt/qtbase,2,0,2,1.000000,0.000000
1000525,qt/qtbase,21,27,48,0.437500,0.562500
1000530,qt/qtbase,58,28,86,0.674419,0.325581
1000532,qt/qtbase,25,20,45,0.555556,0.444444
1000534,qt/qtbase,7,2,9,0.777778,0.222222
1002591,qt/qtbase,6,0,6,1.000000,0.000000
1000548,qt/qtbase,731,397,1128,0.648050,0.351950
1000558,qt/qtbase,2,1,3,0.666667,0.333333
1002609,qt/qtbase,3,1,4,0.750000,0.250000
1000565,qt/qtbase,367,181,548,0.669708,0.330292
1000566,qt/qtbase,8,0,8,1.000000,0.000000
1000567,qt/qtbase,4,1,5,0.800000,0.200000
1000573,qt/qtbase,26,9,35,0.742857,0.257143
1000577,qt/qtbase,5,3,8,0.625000,0.375000
1000580,qt/qtbase,3,0,3,1.000000,0.000000
1002639,qt/qtbase,7,2,9,0.777778,0.222222
1000592,qt/qtbase,461,342,803,0.574097,0.425903
1000604,qt/qtbase,6,4,10,0.600000,0.400000
1000608,qt/qtbase,27,10,37,0.729730,0.270270
1002657,qt/qtbase,3,0,3,1.000000,0.000000
1000610,qt/qtbase,30,17,47,0.638298,0.361702
1000611,qt/qtbase,4,0,4,1.000000,0.000000
1002675,qt/qtbase,1,0,1,1.000000,0.000000
1002676,qt/qtbase,2,0,2,1.000000,0.000000
1000635,qt/qtbase,7,1,8,0.875000,0.125000
1000644,qt/qtbase,2,2,4,0.500000,0.500000
1000645,qt/qtbase,12,3,15,0.800000,0.200000
1002694,qt/qtbase,2,2,4,0.500000,0.500000
1000650,qt/qtbase,2,0,2,1.000000,0.000000
1000661,qt/qtbase,430,236,666,0.645646,0.354354
1000665,qt/qtbase,2,0,2,1.000000,0.000000
1000666,qt/qtbase,22,7,29,0.758621,0.241379
1000669,qt/qtbase,8,6,14,0.571429,0.428571
1002720,qt/qtbase,1,0,1,1.000000,0.000000
1000681,qt/qtbase,263,127,390,0.674359,0.325641
1002744,qt/qtbase,6,3,9,0.666667,0.333333
1002749,qt/qtbase,10,2,12,0.833333,0.166667
1000708,qt/qtbase,344,142,486,0.707819,0.292181
1002782,qt/qtbase,2,1,3,0.666667,0.333333
1000736,qt/qtbase,3,0,3,1.000000,0.000000
1000738,qt/qtbase,269,126,395,0.681013,0.318987
1000739,qt/qtbase,18,7,25,0.720000,0.280000
1000744,qt/qtbase,28,21,49,0.571429,0.428571
1000746,qt/qtbase,2,0,2,1.000000,0.000000
1000750,qt/qtbase,6,7,13,0.461538,0.538462
1000755,qt/qtbase,2,5,7,0.285714,0.714286
1002377,qt/qtbase,12,2,14,0.857143,0.142857
1000762,qt/qtbase,249,120,369,0.674797,0.325203
1000765,qt/qtbase,5,1,6,0.833333,0.166667
1000769,qt/qtbase,5,0,5,1.000000,0.000000
1002820,qt/qtbase,2,2,4,0.500000,0.500000
1002821,qt/qtbase,9,3,12,0.750000,0.250000
1001697,qt/qtbase,40,15,55,0.727273,0.272727
1000785,qt/qtbase,10,1,11,0.909091,0.090909
1000809,qt/qtbase,25,11,36,0.694444,0.305556
1000810,qt/qtbase,71,59,130,0.546154,0.453846
1002859,qt/qtbase,0,2,2,0.000000,1.000000
1002866,qt/qtbase,4,0,4,1.000000,0.000000
1000822,qt/qtbase,230,115,345,0.666667,0.333333
1000831,qt/qtbase,155,112,267,0.580524,0.419476
1000833,qt/qtbase,217,129,346,0.627168,0.372832
1000842,qt/qtbase,2,0,2,1.000000,0.000000
1000843,qt/qtbase,128,67,195,0.656410,0.343590
1000856,qt/qtbase,205,104,309,0.663430,0.336570
1000859,qt/qtbase,3,0,3,1.000000,0.000000
1002909,qt/qtbase,2,1,3,0.666667,0.333333
1000869,qt/qtbase,614,371,985,0.623350,0.376650
1000870,qt/qtbase,178,71,249,0.714859,0.285141
1000873,qt/qtbase,4,2,6,0.666667,0.333333
1000901,qt/qtbase,0,2,2,0.000000,1.000000
1002060,qt/qtbase,2,2,4,0.500000,0.500000
1000912,qt/qtbase,3,4,7,0.428571,0.571429
1000913,qt/qtbase,2,0,2,1.000000,0.000000
1002064,qt/qtbase,2,1,3,0.666667,0.333333
1000944,qt/qtbase,2,0,2,1.000000,0.000000
1000957,qt/qtbase,4,0,4,1.000000,0.000000
1000959,qt/qtbase,4,0,4,1.000000,0.000000
1000971,qt/qtbase,69,38,107,0.644860,0.355140
1000972,qt/qtbase,8,0,8,1.000000,0.000000
1000973,qt/qtbase,13,4,17,0.764706,0.235294
1002413,qt/qtbase,2,0,2,1.000000,0.000000
1000977,qt/qtbase,26,12,38,0.684211,0.315789
1000993,qt/qtbase,6,3,9,0.666667,0.333333
1001026,qt/qtbase,30,37,67,0.447761,0.552239
1002081,qt/qtbase,2,0,2,1.000000,0.000000
1001032,qt/qtbase,282,206,488,0.577869,0.422131
1001039,qt/qtbase,12,17,29,0.413793,0.586207
1001040,qt/qtbase,15,16,31,0.483871,0.516129
1001053,qt/qtbase,73,75,148,0.493243,0.506757
1001058,qt/qtbase,9,19,28,0.321429,0.678571
1001079,qt/qtbase,10,3,13,0.769231,0.230769
1001080,qt/qtbase,11,3,14,0.785714,0.214286
1001081,qt/qtbase,2,0,2,1.000000,0.000000
1001100,qt/qtbase,4,0,4,1.000000,0.000000
1001102,qt/qtbase,2,0,2,1.000000,0.000000
1002093,qt/qtbase,37,32,69,0.536232,0.463768
1001114,qt/qtbase,1,0,1,1.000000,0.000000
1001121,qt/qtbase,2,0,2,1.000000,0.000000
1001132,qt/qtbase,9,4,13,0.692308,0.307692
1001133,qt/qtbase,106,106,212,0.500000,0.500000
1001141,qt/qtbase,84,61,145,0.579310,0.420690
1001156,qt/qtbase,8,5,13,0.615385,0.384615
1001163,qt/qtbase,3,0,3,1.000000,0.000000
1001168,qt/qtbase,2,3,5,0.400000,0.600000
1001184,qt/qtbase,6,0,6,1.000000,0.000000
1001186,qt/qtbase,2,1,3,0.666667,0.333333
1001187,qt/qtbase,2,2,4,0.500000,0.500000
1001190,qt/qtbase,206,117,323,0.637771,0.362229
1001195,qt/qtbase,16,6,22,0.727273,0.272727
1001198,qt/qtbase,13,3,16,0.812500,0.187500
1001210,qt/qtbase,2,0,2,1.000000,0.000000
1001221,qt/qtbase,5,2,7,0.714286,0.285714
1002116,qt/qtbase,5,7,12,0.416667,0.583333
1001245,qt/qtbase,6,3,9,0.666667,0.333333
1001288,qt/qtbase,214,128,342,0.625731,0.374269
1001380,qt/qtbase,261,128,389,0.670951,0.329049
1002140,qt/qtbase,0,3,3,0.000000,1.000000
1001387,qt/qtbase,3,2,5,0.600000,0.400000
1001392,qt/qtbase,7,3,10,0.700000,0.300000
1002144,qt/qtbase,2,2,4,0.500000,0.500000
1001412,qt/qtbase,1,0,1,1.000000,0.000000
1001419,qt/qtbase,102,85,187,0.545455,0.454545
1001441,qt/qtbase,2,0,2,1.000000,0.000000
1001454,qt/qtbase,8,3,11,0.727273,0.272727
1002272,qt/qtchooser,2,0,2,1.000000,0.000000
1001026,qt/qtchooser,4,0,4,1.000000,0.000000
1000004,qt/qtchooser,5,4,9,0.555556,0.444444
1000329,qt/qtchooser,10,7,17,0.588235,0.411765
1000130,qt/qtchooser,4,0,4,1.000000,0.000000
1000049,qt/qtchooser,78,42,120,0.650000,0.350000
1002360,qt/qtchooser,3,5,8,0.375000,0.625000
1000121,qt/qtchooser,8,5,13,0.615385,0.384615
1002113,qt/qtconnectivity,53,27,80,0.662500,0.337500
1000198,qt/qtconnectivity,3,1,4,0.750000,0.250000
1000329,qt/qtconnectivity,1,2,3,0.333333,0.666667
1000971,qt/qtconnectivity,1,3,4,0.250000,0.750000
1000592,qt/qtconnectivity,4,2,6,0.666667,0.333333
1001491,qt/qtconnectivity,1,0,1,1.000000,0.000000
1002006,qt/qtconnectivity,121,81,202,0.599010,0.400990
1000239,qt/qtconnectivity,61,27,88,0.693182,0.306818
1002273,qt/qtconnectivity,3,0,3,1.000000,0.000000
1001775,qt/qtconnectivity,130,41,171,0.760234,0.239766
1002289,qt/qtconnectivity,2,0,2,1.000000,0.000000
1002377,qt/qtconnectivity,2,0,2,1.000000,0.000000
1000762,qt/qtconnectivity,2,0,2,1.000000,0.000000
1002176,qt/qtconnectivity,13,12,25,0.520000,0.480000
1000004,qt/qtconnectivity,8,8,16,0.500000,0.500000
1000133,qt/qtconnectivity,15,17,32,0.468750,0.531250
1000010,qt/qtconnectivity,4,0,4,1.000000,0.000000
1001419,qt/qtconnectivity,2,0,2,1.000000,0.000000
1001549,qt/qtconnectivity,2,0,2,1.000000,0.000000
1000272,qt/qtconnectivity,3,1,4,0.750000,0.250000
1002321,qt/qtconnectivity,4,0,4,1.000000,0.000000
1000146,qt/qtconnectivity,1,2,3,0.333333,0.666667
1000023,qt/qtconnectivity,9,6,15,0.600000,0.400000
1000016,qt/qtconnectivity,0,2,2,0.000000,1.000000
1000298,qt/qtconnectivity,2,0,2,1.000000,0.000000
1002219,qt/qtconnectivity,4,3,7,0.571429,0.428571
1000172,qt/qtconnectivity,7,1,8,0.875000,0.125000
1002093,qt/qtconnectivity,2,0,2,1.000000,0.000000
1000049,qt/qtconnectivity,717,361,1078,0.665121,0.334879
1000054,qt/qtconnectivity,6,4,10,0.600000,0.400000
1000312,qt/qtconnectivity,3,2,5,0.600000,0.400000
1000063,qt/qtconnectivity,5,7,12,0.416667,0.583333
1000318,qt/qtconnectivity,4,1,5,0.800000,0.200000
1000319,qt/qtconnectivity,2,2,4,0.500000,0.500000
1001984,qt/qtdeclarative,1,0,1,1.000000,0.000000
1001572,qt/qtdeclarative,5,1,6,0.833333,0.166667
1000455,qt/qtdeclarative,3,2,5,0.600000,0.400000
1001132,qt/qtdeclarative,3,6,9,0.333333,0.666667
1000971,qt/qtdeclarative,9,1,10,0.900000,0.100000
1000973,qt/qtdeclarative,6,18,24,0.250000,0.750000
1000464,qt/qtdeclarative,6,4,10,0.600000,0.400000
1002670,qt/qtdeclarative,2,0,2,1.000000,0.000000
1002006,qt/qtdeclarative,3,1,4,0.750000,0.250000
1002009,qt/qtdeclarative,2,2,4,0.500000,0.500000
1001931,qt/qtdeclarative,2,4,6,0.333333,0.666667
1001004,qt/qtdeclarative,3,2,5,0.600000,0.400000
1000503,qt/qtdeclarative,5,5,10,0.500000,0.500000
1002676,qt/qtdeclarative,2,2,4,0.500000,0.500000
1001538,qt/qtdeclarative,4,3,7,0.571429,0.428571
1000003,qt/qtdeclarative,347,196,543,0.639042,0.360958
1000004,qt/qtdeclarative,75,51,126,0.595238,0.404762
1000005,qt/qtdeclarative,182,147,329,0.553191,0.446809
1001032,qt/qtdeclarative,7,3,10,0.700000,0.300000
1000009,qt/qtdeclarative,2,0,2,1.000000,0.000000
1000010,qt/qtdeclarative,17,12,29,0.586207,0.413793
1001143,qt/qtdeclarative,77,55,132,0.583333,0.416667
1000012,qt/qtdeclarative,19,5,24,0.791667,0.208333
1001549,qt/qtdeclarative,2,1,3,0.666667,0.333333
1000014,qt/qtdeclarative,160,72,232,0.689655,0.310345
1000015,qt/qtdeclarative,45,16,61,0.737705,0.262295
1000016,qt/qtdeclarative,18,23,41,0.439024,0.560976
1000018,qt/qtdeclarative,24,7,31,0.774194,0.225806
1000019,qt/qtdeclarative,78,45,123,0.634146,0.365854
1000532,qt/qtdeclarative,2,0,2,1.000000,0.000000
1000023,qt/qtdeclarative,59,29,88,0.670455,0.329545
1000024,qt/qtdeclarative,8,3,11,0.727273,0.272727
1000036,qt/qtdeclarative,4,7,11,0.363636,0.636364
1000026,qt/qtdeclarative,10,5,15,0.666667,0.333333
1000029,qt/qtdeclarative,21,24,45,0.466667,0.533333
1000030,qt/qtdeclarative,48,47,95,0.505263,0.494737
1000032,qt/qtdeclarative,23,14,37,0.621622,0.378378
1002000,qt/qtdeclarative,2,0,2,1.000000,0.000000
1000034,qt/qtdeclarative,6,5,11,0.545455,0.454545
1000548,qt/qtdeclarative,13,13,26,0.500000,0.500000
1000037,qt/qtdeclarative,2,1,3,0.666667,0.333333
1000039,qt/qtdeclarative,86,46,132,0.651515,0.348485
1000040,qt/qtdeclarative,42,36,78,0.538462,0.461538
1000043,qt/qtdeclarative,46,25,71,0.647887,0.352113
1000045,qt/qtdeclarative,13,9,22,0.590909,0.409091
1000049,qt/qtdeclarative,14527,8551,23078,0.629474,0.370526
1000052,qt/qtdeclarative,24,12,36,0.666667,0.333333
1000565,qt/qtdeclarative,5,3,8,0.625000,0.375000
1000054,qt/qtdeclarative,126,72,198,0.636364,0.363636
1000055,qt/qtdeclarative,3,5,8,0.375000,0.625000
1000061,qt/qtdeclarative,21,6,27,0.777778,0.222222
1000063,qt/qtdeclarative,99,87,186,0.532258,0.467742
1000064,qt/qtdeclarative,198,135,333,0.594595,0.405405
1000065,qt/qtdeclarative,45,34,79,0.569620,0.430380
1000068,qt/qtdeclarative,9,4,13,0.692308,0.307692
1000070,qt/qtdeclarative,20,15,35,0.571429,0.428571
1000071,qt/qtdeclarative,16,5,21,0.761905,0.238095
1000008,qt/qtdeclarative,17,10,27,0.629630,0.370370
1002122,qt/qtdeclarative,14,5,19,0.736842,0.263158
1000075,qt/qtdeclarative,2,0,2,1.000000,0.000000
1002125,qt/qtdeclarative,12,5,17,0.705882,0.294118
1000078,qt/qtdeclarative,2,1,3,0.666667,0.333333
1000592,qt/qtdeclarative,9,9,18,0.500000,0.500000
1001240,qt/qtdeclarative,2,0,2,1.000000,0.000000
1002642,qt/qtdeclarative,0,1,1,0.000000,1.000000
1000083,qt/qtdeclarative,6,8,14,0.428571,0.571429
1000084,qt/qtdeclarative,35,28,63,0.555556,0.444444
1000085,qt/qtdeclarative,63,32,95,0.663158,0.336842
1001156,qt/qtdeclarative,10,6,16,0.625000,0.375000
1000090,qt/qtdeclarative,63,41,104,0.605769,0.394231
1000091,qt/qtdeclarative,60,46,106,0.566038,0.433962
1002140,qt/qtdeclarative,5,3,8,0.625000,0.375000
1002141,qt/qtdeclarative,2,0,2,1.000000,0.000000
1000096,qt/qtdeclarative,72,59,131,0.549618,0.450382
1000097,qt/qtdeclarative,2,0,2,1.000000,0.000000
1000098,qt/qtdeclarative,18,4,22,0.818182,0.181818
1000099,qt/qtdeclarative,4,0,4,1.000000,0.000000
1000100,qt/qtdeclarative,23,17,40,0.575000,0.425000
1000101,qt/qtdeclarative,44,31,75,0.586667,0.413333
1000105,qt/qtdeclarative,147,112,259,0.567568,0.432432
1000108,qt/qtdeclarative,37,22,59,0.627119,0.372881
1001133,qt/qtdeclarative,9,11,20,0.450000,0.550000
1000110,qt/qtdeclarative,33,21,54,0.611111,0.388889
1002160,qt/qtdeclarative,8,6,14,0.571429,0.428571
1002161,qt/qtdeclarative,23,6,29,0.793103,0.206897
1000116,qt/qtdeclarative,0,1,1,0.000000,1.000000
1000118,qt/qtdeclarative,39,34,73,0.534247,0.465753
1000119,qt/qtdeclarative,177,125,302,0.586093,0.413907
1000120,qt/qtdeclarative,18,7,25,0.720000,0.280000
1000121,qt/qtdeclarative,279,212,491,0.568228,0.431772
1000123,qt/qtdeclarative,2,2,4,0.500000,0.500000
1000124,qt/qtdeclarative,16,13,29,0.551724,0.448276
1000128,qt/qtdeclarative,1,8,9,0.111111,0.888889
1000130,qt/qtdeclarative,97,69,166,0.584337,0.415663
1000131,qt/qtdeclarative,30,20,50,0.600000,0.400000
1000132,qt/qtdeclarative,25,15,40,0.625000,0.375000
1000566,qt/qtdeclarative,2,0,2,1.000000,0.000000
1000140,qt/qtdeclarative,38,23,61,0.622951,0.377049
1000141,qt/qtdeclarative,4,2,6,0.666667,0.333333
1000144,qt/qtdeclarative,2,0,2,1.000000,0.000000
1000147,qt/qtdeclarative,2,1,3,0.666667,0.333333
1000661,qt/qtdeclarative,22,16,38,0.578947,0.421053
1000152,qt/qtdeclarative,7,0,7,1.000000,0.000000
1000666,qt/qtdeclarative,2,0,2,1.000000,0.000000
1000155,qt/qtdeclarative,4,2,6,0.666667,0.333333
1002176,qt/qtdeclarative,1,5,6,0.166667,0.833333
1000160,qt/qtdeclarative,1,1,2,0.500000,0.500000
1002192,qt/qtdeclarative,6,0,6,1.000000,0.000000
1000166,qt/qtdeclarative,4,4,8,0.500000,0.500000
1000167,qt/qtdeclarative,35,29,64,0.546875,0.453125
1000169,qt/qtdeclarative,14,10,24,0.583333,0.416667
1000171,qt/qtdeclarative,0,1,1,0.000000,1.000000
1000173,qt/qtdeclarative,2,0,2,1.000000,0.000000
1000181,qt/qtdeclarative,5,4,9,0.555556,0.444444
1000183,qt/qtdeclarative,7,3,10,0.700000,0.300000
1000184,qt/qtdeclarative,4,0,4,1.000000,0.000000
1000185,qt/qtdeclarative,155,140,295,0.525424,0.474576
1000193,qt/qtdeclarative,4,0,4,1.000000,0.000000
1000708,qt/qtdeclarative,4,0,4,1.000000,0.000000
1000198,qt/qtdeclarative,5,0,5,1.000000,0.000000
1000577,qt/qtdeclarative,8,0,8,1.000000,0.000000
1000203,qt/qtdeclarative,75,60,135,0.555556,0.444444
1000207,qt/qtdeclarative,2,0,2,1.000000,0.000000
1000216,qt/qtdeclarative,3,3,6,0.500000,0.500000
1002116,qt/qtdeclarative,35,33,68,0.514706,0.485294
1000220,qt/qtdeclarative,26,20,46,0.565217,0.434783
1001690,qt/qtdeclarative,2,0,2,1.000000,0.000000
1002272,qt/qtdeclarative,229,151,380,0.602632,0.397368
1000738,qt/qtdeclarative,151,75,226,0.668142,0.331858
1000235,qt/qtdeclarative,2,0,2,1.000000,0.000000
1001775,qt/qtdeclarative,2,1,3,0.666667,0.333333
1002289,qt/qtdeclarative,8,1,9,0.888889,0.111111
1000762,qt/qtdeclarative,18,8,26,0.692308,0.307692
1000259,qt/qtdeclarative,2,0,2,1.000000,0.000000
1000260,qt/qtdeclarative,4,1,5,0.800000,0.200000
1002209,qt/qtdeclarative,2,0,2,1.000000,0.000000
1001288,qt/qtdeclarative,2,0,2,1.000000,0.000000
1000270,qt/qtdeclarative,34,15,49,0.693878,0.306122
1000833,qt/qtdeclarative,2,2,4,0.500000,0.500000
1002321,qt/qtdeclarative,9,1,10,0.900000,0.100000
1000274,qt/qtdeclarative,20,12,32,0.625000,0.375000
1000590,qt/qtdeclarative,6,3,9,0.666667,0.333333
1000280,qt/qtdeclarative,1,0,1,1.000000,0.000000
1001616,qt/qtdeclarative,11,7,18,0.611111,0.388889
1001190,qt/qtdeclarative,7,2,9,0.777778,0.222222
1000809,qt/qtdeclarative,3,3,6,0.500000,0.500000
1000298,qt/qtdeclarative,41,17,58,0.706897,0.293103
1002866,qt/qtdeclarative,2,0,2,1.000000,0.000000
1000307,qt/qtdeclarative,7,1,8,0.875000,0.125000
1000308,qt/qtdeclarative,0,3,3,0.000000,1.000000
1000822,qt/qtdeclarative,3,2,5,0.600000,0.400000
1000681,qt/qtdeclarative,13,3,16,0.812500,0.187500
1000312,qt/qtdeclarative,37,9,46,0.804348,0.195652
1000318,qt/qtdeclarative,2,1,3,0.666667,0.333333
1001857,qt/qtdeclarative,3,1,4,0.750000,0.250000
1000323,qt/qtdeclarative,3,3,6,0.500000,0.500000
1000324,qt/qtdeclarative,3,1,4,0.750000,0.250000
1000327,qt/qtdeclarative,22,4,26,0.846154,0.153846
1000328,qt/qtdeclarative,3,3,6,0.500000,0.500000
1000329,qt/qtdeclarative,34,19,53,0.641509,0.358491
1000331,qt/qtdeclarative,2,0,2,1.000000,0.000000
1000334,qt/qtdeclarative,10,3,13,0.769231,0.230769
1000338,qt/qtdeclarative,4,1,5,0.800000,0.200000
1000341,qt/qtdeclarative,2,0,2,1.000000,0.000000
1000516,qt/qtdeclarative,6,2,8,0.750000,0.250000
1000351,qt/qtdeclarative,2,0,2,1.000000,0.000000
1002643,qt/qtdeclarative,6,4,10,0.600000,0.400000
1000869,qt/qtdeclarative,11,10,21,0.523810,0.476190
1002416,qt/qtdeclarative,4,1,5,0.800000,0.200000
1000264,qt/qtdeclarative,2,2,4,0.500000,0.500000
1000391,qt/qtdeclarative,2,2,4,0.500000,0.500000
1001419,qt/qtdeclarative,30,16,46,0.652174,0.347826
1000525,qt/qtdeclarative,2,2,4,0.500000,0.500000
1002232,qt/qtdeclarative,24,25,49,0.489796,0.510204
1000402,qt/qtdeclarative,2,0,2,1.000000,0.000000
1000405,qt/qtdeclarative,44,2,46,0.956522,0.043478
1002148,qt/qtdeclarative,3,3,6,0.500000,0.500000
1002469,qt/qtdeclarative,2,0,2,1.000000,0.000000
1002472,qt/qtdeclarative,1,0,1,1.000000,0.000000
1000530,qt/qtdeclarative,4,0,4,1.000000,0.000000
1001454,qt/qtdeclarative,4,0,4,1.000000,0.000000
1001967,qt/qtdeclarative,18,6,24,0.750000,0.250000
1002128,qt/qtdeclarative,49,14,63,0.777778,0.222222
1000971,qt/qtdoc,8,3,11,0.727273,0.272727
1000972,qt/qtdoc,29,3,32,0.906250,0.093750
1002006,qt/qtdoc,4,2,6,0.666667,0.333333
1000003,qt/qtdoc,12,7,19,0.631579,0.368421
1000004,qt/qtdoc,54,22,76,0.710526,0.289474
1000007,qt/qtdoc,3,2,5,0.600000,0.400000
1001032,qt/qtdoc,1,2,3,0.333333,0.666667
1000014,qt/qtdoc,22,18,40,0.550000,0.450000
1000015,qt/qtdoc,5,3,8,0.625000,0.375000
1000534,qt/qtdoc,2,1,3,0.666667,0.333333
1000023,qt/qtdoc,22,4,26,0.846154,0.153846
1001572,qt/qtdoc,53,38,91,0.582418,0.417582
1000026,qt/qtdoc,44,35,79,0.556962,0.443038
1000032,qt/qtdoc,4,0,4,1.000000,0.000000
1000033,qt/qtdoc,1,2,3,0.333333,0.666667
1000548,qt/qtdoc,2,0,2,1.000000,0.000000
1000046,qt/qtdoc,2,0,2,1.000000,0.000000
1000049,qt/qtdoc,2054,840,2894,0.709744,0.290256
1000052,qt/qtdoc,3,2,5,0.600000,0.400000
1000053,qt/qtdoc,2,0,2,1.000000,0.000000
1000054,qt/qtdoc,155,97,252,0.615079,0.384921
1000063,qt/qtdoc,6,8,14,0.428571,0.571429
1000064,qt/qtdoc,1,0,1,1.000000,0.000000
1000577,qt/qtdoc,6,0,6,1.000000,0.000000
1000070,qt/qtdoc,2,2,4,0.500000,0.500000
1000071,qt/qtdoc,14,8,22,0.636364,0.363636
1001100,qt/qtdoc,7,3,10,0.700000,0.300000
1000592,qt/qtdoc,4,8,12,0.333333,0.666667
1000084,qt/qtdoc,10,2,12,0.833333,0.166667
1000085,qt/qtdoc,7,5,12,0.583333,0.416667
1001623,qt/qtdoc,1,2,3,0.333333,0.666667
1000091,qt/qtdoc,2,1,3,0.666667,0.333333
1000604,qt/qtdoc,2,5,7,0.285714,0.714286
1000097,qt/qtdoc,7,6,13,0.538462,0.461538
1000101,qt/qtdoc,4,3,7,0.571429,0.428571
1000105,qt/qtdoc,2,0,2,1.000000,0.000000
1000108,qt/qtdoc,3,4,7,0.428571,0.571429
1000109,qt/qtdoc,2,2,4,0.500000,0.500000
1000110,qt/qtdoc,3,2,5,0.600000,0.400000
1000113,qt/qtdoc,4,0,4,1.000000,0.000000
1000120,qt/qtdoc,2,2,4,0.500000,0.500000
1000121,qt/qtdoc,32,16,48,0.666667,0.333333
1000124,qt/qtdoc,24,20,44,0.545455,0.454545
1000130,qt/qtdoc,4,0,4,1.000000,0.000000
1000132,qt/qtdoc,22,13,35,0.628571,0.371429
1002192,qt/qtdoc,14,4,18,0.777778,0.222222
1000146,qt/qtdoc,0,1,1,0.000000,1.000000
1000661,qt/qtdoc,3,2,5,0.600000,0.400000
1000153,qt/qtdoc,1,0,1,1.000000,0.000000
1000164,qt/qtdoc,2,1,3,0.666667,0.333333
1000166,qt/qtdoc,132,49,181,0.729282,0.270718
1000681,qt/qtdoc,1,3,4,0.250000,0.750000
1000698,qt/qtdoc,2,3,5,0.400000,0.600000
1000708,qt/qtdoc,3,0,3,1.000000,0.000000
1000198,qt/qtdoc,6,1,7,0.857143,0.142857
1000199,qt/qtdoc,4,0,4,1.000000,0.000000
1002272,qt/qtdoc,5,1,6,0.833333,0.166667
1000225,qt/qtdoc,2,0,2,1.000000,0.000000
1000738,qt/qtdoc,0,2,2,0.000000,1.000000
1000239,qt/qtdoc,2,0,2,1.000000,0.000000
1002289,qt/qtdoc,3,0,3,1.000000,0.000000
1000250,qt/qtdoc,3,0,3,1.000000,0.000000
1000765,qt/qtdoc,40,10,50,0.800000,0.200000
1001288,qt/qtdoc,5,1,6,0.833333,0.166667
1000785,qt/qtdoc,2,2,4,0.500000,0.500000
1000809,qt/qtdoc,3,1,4,0.750000,0.250000
1000298,qt/qtdoc,56,18,74,0.756757,0.243243
1000312,qt/qtdoc,2,3,5,0.400000,0.600000
1000319,qt/qtdoc,16,2,18,0.888889,0.111111
1000835,qt/qtdoc,2,0,2,1.000000,0.000000
1000327,qt/qtdoc,1,2,3,0.333333,0.666667
1000328,qt/qtdoc,18,4,22,0.818182,0.181818
1000329,qt/qtdoc,18,11,29,0.620690,0.379310
1000334,qt/qtdoc,1,2,3,0.333333,0.666667
1000338,qt/qtdoc,14,1,15,0.933333,0.066667
1000340,qt/qtdoc,7,7,14,0.500000,0.500000
1000942,qt/qtdoc,3,0,3,1.000000,0.000000
1000516,qt/qtdoc,2,0,2,1.000000,0.000000
1000870,qt/qtdoc,7,4,11,0.636364,0.363636
1000008,qt/qtdoc,2,0,2,1.000000,0.000000
1000391,qt/qtdoc,2,5,7,0.285714,0.714286
1001419,qt/qtdoc,71,21,92,0.771739,0.228261
1000912,qt/qtdoc,2,0,2,1.000000,0.000000
1000036,qt/qtdoc,12,9,21,0.571429,0.428571
1002472,qt/qtdoc,5,3,8,0.625000,0.375000
1001454,qt/qtdoc,4,0,4,1.000000,0.000000
1001967,qt/qtdoc,49,28,77,0.636364,0.363636
1001982,qt/qtdoc,4,0,4,1.000000,0.000000
1000004,qt/qtdocgallery,1,2,3,0.333333,0.666667
1002289,qt/qtdocgallery,2,0,2,1.000000,0.000000
1000329,qt/qtdocgallery,3,2,5,0.600000,0.400000
1000971,qt/qtdocgallery,2,0,2,1.000000,0.000000
1000046,qt/qtdocgallery,2,0,2,1.000000,0.000000
1000016,qt/qtdocgallery,1,2,3,0.333333,0.666667
1000049,qt/qtdocgallery,122,28,150,0.813333,0.186667
1000023,qt/qtdocgallery,2,0,2,1.000000,0.000000
1000312,qt/qtdocgallery,2,1,3,0.666667,0.333333
1000063,qt/qtdocgallery,2,0,2,1.000000,0.000000
1000130,qt/qtenginio,20,19,39,0.512821,0.487179
1002907,qt/qtenginio,2,0,2,1.000000,0.000000
1000140,qt/qtenginio,2,0,2,1.000000,0.000000
1000098,qt/qtenginio,2,0,2,1.000000,0.000000
1000049,qt/qtenginio,500,141,641,0.780031,0.219969
1000307,qt/qtenginio,1,2,3,0.333333,0.666667
1000091,qt/qtenginio,17,15,32,0.531250,0.468750
1001311,qt/qtfeedback,7,2,9,0.777778,0.222222
1000971,qt/qtfeedback,1,0,1,1.000000,0.000000
1000100,qt/qtfeedback,4,0,4,1.000000,0.000000
1000273,qt/qtfeedback,2,0,2,1.000000,0.000000
1000329,qt/qtfeedback,1,2,3,0.333333,0.666667
1000010,qt/qtfeedback,4,0,4,1.000000,0.000000
1000299,qt/qtfeedback,2,4,6,0.333333,0.666667
1000049,qt/qtfeedback,228,70,298,0.765101,0.234899
1000116,qt/qtfeedback,9,10,19,0.473684,0.526316
1000023,qt/qtfeedback,2,3,5,0.400000,0.600000
1000004,qt/qtfeedback,1,2,3,0.333333,0.666667
1000063,qt/qtfeedback,5,10,15,0.333333,0.666667
1002289,qt/qtfeedback,2,0,2,1.000000,0.000000
1000127,qt/qtfeedback,4,2,6,0.666667,0.333333
1000004,qt/qtftp,5,6,11,0.454545,0.545455
1000329,qt/qtftp,5,2,7,0.714286,0.285714
1000971,qt/qtftp,2,2,4,0.500000,0.500000
1000049,qt/qtftp,44,18,62,0.709677,0.290323
1000023,qt/qtftp,2,2,4,0.500000,0.500000
1000093,qt/qtftp,4,0,4,1.000000,0.000000
1000577,qt/qtgraphicaleffects,8,1,9,0.888889,0.111111
1000738,qt/qtgraphicaleffects,2,0,2,1.000000,0.000000
1000971,qt/qtgraphicaleffects,3,0,3,1.000000,0.000000
1000071,qt/qtgraphicaleffects,2,0,2,1.000000,0.000000
1000809,qt/qtgraphicaleffects,7,0,7,1.000000,0.000000
1000298,qt/qtgraphicaleffects,6,0,6,1.000000,0.000000
1000267,qt/qtgraphicaleffects,2,0,2,1.000000,0.000000
1001454,qt/qtgraphicaleffects,6,1,7,0.857143,0.142857
1000111,qt/qtgraphicaleffects,3,2,5,0.600000,0.400000
1000049,qt/qtgraphicaleffects,231,36,267,0.865169,0.134831
1001971,qt/qtgraphicaleffects,2,0,2,1.000000,0.000000
1001419,qt/qtgraphicaleffects,4,0,4,1.000000,0.000000
1000120,qt/qtgraphicaleffects,4,0,4,1.000000,0.000000
1000251,qt/qtgraphicaleffects,1,0,1,1.000000,0.000000
1000668,qt/qtgraphicaleffects,2,0,2,1.000000,0.000000
1000318,qt/qtgraphicaleffects,2,0,2,1.000000,0.000000
1000063,qt/qtgraphicaleffects,5,3,8,0.625000,0.375000
1000049,qt/qthttp,39,26,65,0.600000,0.400000
1000004,qt/qthttp,6,6,12,0.500000,0.500000
1000093,qt/qthttp,3,1,4,0.750000,0.250000
1000023,qt/qthttp,1,2,3,0.333333,0.666667
1000577,qt/qtimageformats,4,0,4,1.000000,0.000000
1002377,qt/qtimageformats,2,0,2,1.000000,0.000000
1000203,qt/qtimageformats,10,6,16,0.625000,0.375000
1000078,qt/qtimageformats,7,9,16,0.437500,0.562500
1000338,qt/qtimageformats,1,2,3,0.333333,0.666667
1000084,qt/qtimageformats,7,6,13,0.538462,0.461538
1000090,qt/qtimageformats,4,2,6,0.666667,0.333333
1000121,qt/qtimageformats,0,2,2,0.000000,1.000000
1000004,qt/qtimageformats,5,6,11,0.454545,0.545455
1000016,qt/qtimageformats,2,2,4,0.500000,0.500000
1000530,qt/qtimageformats,1,0,1,1.000000,0.000000
1000023,qt/qtimageformats,2,0,2,1.000000,0.000000
1000033,qt/qtimageformats,2,3,5,0.400000,0.600000
1000681,qt/qtimageformats,5,1,6,0.833333,0.166667
1000298,qt/qtimageformats,3,0,3,1.000000,0.000000
1000171,qt/qtimageformats,3,7,10,0.300000,0.700000
1001454,qt/qtimageformats,4,0,4,1.000000,0.000000
1000049,qt/qtimageformats,204,53,257,0.793774,0.206226
1000822,qt/qtimageformats,2,1,3,0.666667,0.333333
1002359,qt/qtimageformats,3,0,3,1.000000,0.000000
1000312,qt/qtimageformats,1,0,1,1.000000,0.000000
1001982,qt/qtimageformats,2,0,2,1.000000,0.000000
1000063,qt/qtimageformats,5,5,10,0.500000,0.500000
1000577,qt/qtjsbackend,4,0,4,1.000000,0.000000
1000327,qt/qtjsbackend,0,2,2,0.000000,1.000000
1000329,qt/qtjsbackend,7,2,9,0.777778,0.222222
1000203,qt/qtjsbackend,4,6,10,0.400000,0.600000
1000590,qt/qtjsbackend,8,2,10,0.800000,0.200000
1000464,qt/qtjsbackend,3,9,12,0.250000,0.750000
1000338,qt/qtjsbackend,2,0,2,1.000000,0.000000
1000003,qt/qtjsbackend,1,2,3,0.333333,0.666667
1002137,qt/qtjsbackend,2,0,2,1.000000,0.000000
1000091,qt/qtjsbackend,1,0,1,1.000000,0.000000
1000096,qt/qtjsbackend,6,3,9,0.666667,0.333333
1001380,qt/qtjsbackend,5,0,5,1.000000,0.000000
1000105,qt/qtjsbackend,2,1,3,0.666667,0.333333
1001775,qt/qtjsbackend,2,0,2,1.000000,0.000000
1001032,qt/qtjsbackend,5,6,11,0.454545,0.545455
1000121,qt/qtjsbackend,1,0,1,1.000000,0.000000
1000762,qt/qtjsbackend,0,1,1,0.000000,1.000000
1001277,qt/qtjsbackend,2,1,3,0.666667,0.333333
1002272,qt/qtjsbackend,2,1,3,0.666667,0.333333
1000075,qt/qtjsbackend,6,0,6,1.000000,0.000000
1000004,qt/qtjsbackend,1,2,3,0.333333,0.666667
1000005,qt/qtjsbackend,3,2,5,0.600000,0.400000
1000391,qt/qtjsbackend,3,5,8,0.375000,0.625000
1001288,qt/qtjsbackend,2,2,4,0.500000,0.500000
1000661,qt/qtjsbackend,5,5,10,0.500000,0.500000
1000023,qt/qtjsbackend,3,2,5,0.600000,0.400000
1000163,qt/qtjsbackend,1,0,1,1.000000,0.000000
1002092,qt/qtjsbackend,2,0,2,1.000000,0.000000
1000049,qt/qtjsbackend,340,185,525,0.647619,0.352381
1000565,qt/qtjsbackend,2,0,2,1.000000,0.000000
1001982,qt/qtjsbackend,2,0,2,1.000000,0.000000
1000971,qt/qtjsondb,2,0,2,1.000000,0.000000
1000327,qt/qtjsondb,16,1,17,0.941176,0.058824
1000329,qt/qtjsondb,11,2,13,0.846154,0.153846
1000203,qt/qtjsondb,2,3,5,0.400000,0.600000
1000464,qt/qtjsondb,4,2,6,0.666667,0.333333
1000472,qt/qtjsondb,2,0,2,1.000000,0.000000
1000084,qt/qtjsondb,37,31,68,0.544118,0.455882
1000216,qt/qtjsondb,262,216,478,0.548117,0.451883
1000091,qt/qtjsondb,20,13,33,0.606061,0.393939
1000093,qt/qtjsondb,3,3,6,0.500000,0.500000
1002289,qt/qtjsondb,2,0,2,1.000000,0.000000
1000104,qt/qtjsondb,2,4,6,0.333333,0.666667
1000238,qt/qtjsondb,101,69,170,0.594118,0.405882
1001032,qt/qtjsondb,4,2,6,0.666667,0.333333
1000242,qt/qtjsondb,3,0,3,1.000000,0.000000
1000503,qt/qtjsondb,5,3,8,0.625000,0.375000
1000762,qt/qtjsondb,2,0,2,1.000000,0.000000
1000124,qt/qtjsondb,12,14,26,0.461538,0.538462
1000129,qt/qtjsondb,1,0,1,1.000000,0.000000
1000331,qt/qtjsondb,5,4,9,0.555556,0.444444
1000004,qt/qtjsondb,16,7,23,0.695652,0.304348
1000264,qt/qtjsondb,180,150,330,0.545455,0.454545
1000014,qt/qtjsondb,2,0,2,1.000000,0.000000
1000016,qt/qtjsondb,7,1,8,0.875000,0.125000
1000785,qt/qtjsondb,103,86,189,0.544974,0.455026
1000147,qt/qtjsondb,128,59,187,0.684492,0.315508
1000023,qt/qtjsondb,5,3,8,0.625000,0.375000
1001312,qt/qtjsondb,5,3,8,0.625000,0.375000
1000144,qt/qtjsondb,68,68,136,0.500000,0.500000
1000034,qt/qtjsondb,16,16,32,0.500000,0.500000
1000037,qt/qtjsondb,322,268,590,0.545763,0.454237
1000809,qt/qtjsondb,1,0,1,1.000000,0.000000
1000172,qt/qtjsondb,4,5,9,0.444444,0.555556
1000045,qt/qtjsondb,1,0,1,1.000000,0.000000
1000046,qt/qtjsondb,1,0,1,1.000000,0.000000
1000049,qt/qtjsondb,2692,1415,4107,0.655466,0.344534
1001303,qt/qtjsondb,8,10,18,0.444444,0.555556
1000053,qt/qtjsondb,0,2,2,0.000000,1.000000
1000312,qt/qtjsondb,2,0,2,1.000000,0.000000
1000190,qt/qtjsondb,25,20,45,0.555556,0.444444
1000063,qt/qtjsondb,31,10,41,0.756098,0.243902
1002752,qt/qtlocation,10,8,18,0.555556,0.444444
1001857,qt/qtlocation,2,0,2,1.000000,0.000000
1001457,qt/qtlocation,0,1,1,0.000000,1.000000
1000822,qt/qtlocation,2,0,2,1.000000,0.000000
1000198,qt/qtlocation,24,17,41,0.585366,0.414634
1002113,qt/qtlocation,52,42,94,0.553191,0.446809
1000329,qt/qtlocation,2,2,4,0.500000,0.500000
1000971,qt/qtlocation,2,0,2,1.000000,0.000000
1002848,qt/qtlocation,13,5,18,0.722222,0.277778
1000334,qt/qtlocation,2,0,2,1.000000,0.000000
1000592,qt/qtlocation,1,2,3,0.333333,0.666667
1000209,qt/qtlocation,0,4,4,0.000000,1.000000
1000003,qt/qtlocation,0,2,2,0.000000,1.000000
1000212,qt/qtlocation,11,4,15,0.733333,0.266667
1002006,qt/qtlocation,44,39,83,0.530120,0.469880
1000217,qt/qtlocation,30,8,38,0.789474,0.210526
1000094,qt/qtlocation,77,52,129,0.596899,0.403101
1002693,qt/qtlocation,4,6,10,0.400000,0.600000
1001377,qt/qtlocation,18,9,27,0.666667,0.333333
1000098,qt/qtlocation,1,0,1,1.000000,0.000000
1000615,qt/qtlocation,4,2,6,0.666667,0.333333
1001775,qt/qtlocation,5,3,8,0.625000,0.375000
1002289,qt/qtlocation,2,0,2,1.000000,0.000000
1000120,qt/qtlocation,9,7,16,0.562500,0.437500
1000681,qt/qtlocation,2,0,2,1.000000,0.000000
1002174,qt/qtlocation,0,2,2,0.000000,1.000000
1000128,qt/qtlocation,330,269,599,0.550918,0.449082
1001409,qt/qtlocation,4,9,13,0.307692,0.692308
1000131,qt/qtlocation,2,0,2,1.000000,0.000000
1000004,qt/qtlocation,12,6,18,0.666667,0.333333
1000133,qt/qtlocation,105,81,186,0.564516,0.435484
1000121,qt/qtlocation,1,2,3,0.333333,0.666667
1000014,qt/qtlocation,4,0,4,1.000000,0.000000
1000143,qt/qtlocation,201,104,305,0.659016,0.340984
1000016,qt/qtlocation,1,3,4,0.250000,0.750000
1000312,qt/qtlocation,14,8,22,0.636364,0.363636
1001682,qt/qtlocation,66,16,82,0.804878,0.195122
1000661,qt/qtlocation,2,0,2,1.000000,0.000000
1000023,qt/qtlocation,8,3,11,0.727273,0.272727
1002464,qt/qtlocation,18,8,26,0.692308,0.307692
1000674,qt/qtlocation,3,0,3,1.000000,0.000000
1000292,qt/qtlocation,2,0,2,1.000000,0.000000
1002853,qt/qtlocation,13,4,17,0.764706,0.235294
1000934,qt/qtlocation,81,43,124,0.653226,0.346774
1000169,qt/qtlocation,2,0,2,1.000000,0.000000
1000298,qt/qtlocation,2,0,2,1.000000,0.000000
1000171,qt/qtlocation,2,0,2,1.000000,0.000000
1000054,qt/qtlocation,5,1,6,0.833333,0.166667
1000049,qt/qtlocation,3070,1399,4469,0.686955,0.313045
1001846,qt/qtlocation,51,25,76,0.671053,0.328947
1000183,qt/qtlocation,58,24,82,0.707317,0.292683
1000184,qt/qtlocation,54,31,85,0.635294,0.364706
1000185,qt/qtlocation,4,7,11,0.363636,0.636364
1000186,qt/qtlocation,107,62,169,0.633136,0.366864
1000063,qt/qtlocation,10,14,24,0.416667,0.583333
1002749,qt/qtlocation,2,0,2,1.000000,0.000000
1000447,qt/qtlocation,3,0,3,1.000000,0.000000
1000032,qt/qtmacextras,8,2,10,0.800000,0.200000
1000592,qt/qtmacextras,4,2,6,0.666667,0.333333
1000738,qt/qtmacextras,2,0,2,1.000000,0.000000
1000312,qt/qtmacextras,4,2,6,0.666667,0.333333
1002472,qt/qtmacextras,2,0,2,1.000000,0.000000
1000140,qt/qtmacextras,7,1,8,0.875000,0.125000
1000298,qt/qtmacextras,2,0,2,1.000000,0.000000
1000043,qt/qtmacextras,22,14,36,0.611111,0.388889
1000108,qt/qtmacextras,8,9,17,0.470588,0.529412
1001040,qt/qtmacextras,1,2,3,0.333333,0.666667
1000049,qt/qtmacextras,205,101,306,0.669935,0.330065
1000530,qt/qtmacextras,58,27,85,0.682353,0.317647
1001080,qt/qtmacextras,4,5,9,0.444444,0.555556
1000121,qt/qtmacextras,4,1,5,0.800000,0.200000
1002192,qt/qtmacextras,0,1,1,0.000000,1.000000
1000049,qt/qtmodeling,694,91,785,0.884076,0.115924
1002167,qt/qtmodeling,5,2,7,0.714286,0.285714
1000023,qt/qtmodeling,2,2,4,0.500000,0.500000
1000448,qt/qtmultimedia,3,2,5,0.600000,0.400000
1000205,qt/qtmultimedia,2,0,2,1.000000,0.000000
1000971,qt/qtmultimedia,2,0,2,1.000000,0.000000
1002001,qt/qtmultimedia,1,0,1,1.000000,0.000000
1000328,qt/qtmultimedia,2,1,3,0.666667,0.333333
1002006,qt/qtmultimedia,2,1,3,0.666667,0.333333
1002526,qt/qtmultimedia,3,2,5,0.600000,0.400000
1000503,qt/qtmultimedia,2,0,2,1.000000,0.000000
1000003,qt/qtmultimedia,4,2,6,0.666667,0.333333
1000004,qt/qtmultimedia,39,29,68,0.573529,0.426471
1000005,qt/qtmultimedia,2,0,2,1.000000,0.000000
1001032,qt/qtmultimedia,2,0,2,1.000000,0.000000
1000013,qt/qtmultimedia,2,0,2,1.000000,0.000000
1000014,qt/qtmultimedia,7,1,8,0.875000,0.125000
1000015,qt/qtmultimedia,2,0,2,1.000000,0.000000
1000016,qt/qtmultimedia,4,3,7,0.571429,0.428571
1000023,qt/qtmultimedia,18,3,21,0.857143,0.142857
1001572,qt/qtmultimedia,3,1,4,0.750000,0.250000
1000026,qt/qtmultimedia,2,0,2,1.000000,0.000000
1000032,qt/qtmultimedia,3,1,4,0.750000,0.250000
1000033,qt/qtmultimedia,9,4,13,0.692308,0.307692
1000548,qt/qtmultimedia,2,0,2,1.000000,0.000000
1000041,qt/qtmultimedia,135,98,233,0.579399,0.420601
1000049,qt/qtmultimedia,2279,1182,3461,0.658480,0.341520
1000052,qt/qtmultimedia,11,4,15,0.733333,0.266667
1000565,qt/qtmultimedia,3,0,3,1.000000,0.000000
1000054,qt/qtmultimedia,16,11,27,0.592593,0.407407
1000063,qt/qtmultimedia,21,16,37,0.567568,0.432432
1000577,qt/qtmultimedia,6,0,6,1.000000,0.000000
1000066,qt/qtmultimedia,73,72,145,0.503448,0.496552
1002117,qt/qtmultimedia,5,3,8,0.625000,0.375000
1000074,qt/qtmultimedia,14,6,20,0.700000,0.300000
1000075,qt/qtmultimedia,32,6,38,0.842105,0.157895
1000077,qt/qtmultimedia,2,0,2,1.000000,0.000000
1000592,qt/qtmultimedia,0,2,2,0.000000,1.000000
1000084,qt/qtmultimedia,2,0,2,1.000000,0.000000
1000085,qt/qtmultimedia,2,0,2,1.000000,0.000000
1002137,qt/qtmultimedia,7,2,9,0.777778,0.222222
1000100,qt/qtmultimedia,1,2,3,0.333333,0.666667
1000120,qt/qtmultimedia,3,2,5,0.600000,0.400000
1000121,qt/qtmultimedia,13,2,15,0.866667,0.133333
1000124,qt/qtmultimedia,1,2,3,0.333333,0.666667
1000127,qt/qtmultimedia,352,242,594,0.592593,0.407407
1002176,qt/qtmultimedia,17,6,23,0.739130,0.260870
1000129,qt/qtmultimedia,2,2,4,0.500000,0.500000
1000130,qt/qtmultimedia,0,4,4,0.000000,1.000000
1001419,qt/qtmultimedia,12,3,15,0.800000,0.200000
1000132,qt/qtmultimedia,6,1,7,0.857143,0.142857
1002192,qt/qtmultimedia,3,0,3,1.000000,0.000000
1000661,qt/qtmultimedia,26,11,37,0.702703,0.297297
1000153,qt/qtmultimedia,2,1,3,0.666667,0.333333
1000166,qt/qtmultimedia,3,3,6,0.500000,0.500000
1000681,qt/qtmultimedia,0,1,1,0.000000,1.000000
1001195,qt/qtmultimedia,3,1,4,0.750000,0.250000
1000174,qt/qtmultimedia,96,55,151,0.635762,0.364238
1000183,qt/qtmultimedia,2,4,6,0.333333,0.666667
1000198,qt/qtmultimedia,7,6,13,0.538462,0.461538
1000203,qt/qtmultimedia,1,2,3,0.333333,0.666667
1001229,qt/qtmultimedia,4,1,5,0.800000,0.200000
1000738,qt/qtmultimedia,9,1,10,0.900000,0.100000
1001775,qt/qtmultimedia,12,1,13,0.923077,0.076923
1002289,qt/qtmultimedia,2,0,2,1.000000,0.000000
1001353,qt/qtmultimedia,6,0,6,1.000000,0.000000
1000762,qt/qtmultimedia,53,29,82,0.646341,0.353659
1000260,qt/qtmultimedia,4,6,10,0.400000,0.600000
1001288,qt/qtmultimedia,12,0,12,1.000000,0.000000
1002321,qt/qtmultimedia,2,0,2,1.000000,0.000000
1000787,qt/qtmultimedia,2,0,2,1.000000,0.000000
1000298,qt/qtmultimedia,14,2,16,0.875000,0.125000
1000935,qt/qtmultimedia,65,34,99,0.656566,0.343434
1000303,qt/qtmultimedia,4,4,8,0.500000,0.500000
1000312,qt/qtmultimedia,10,5,15,0.666667,0.333333
1000835,qt/qtmultimedia,4,0,4,1.000000,0.000000
1002374,qt/qtmultimedia,2,0,2,1.000000,0.000000
1000327,qt/qtmultimedia,5,4,9,0.555556,0.444444
1001352,qt/qtmultimedia,46,20,66,0.696970,0.303030
1000329,qt/qtmultimedia,1,1,2,0.500000,0.500000
1000843,qt/qtmultimedia,38,11,49,0.775510,0.224490
1000334,qt/qtmultimedia,2,0,2,1.000000,0.000000
1000338,qt/qtmultimedia,2,0,2,1.000000,0.000000
1001380,qt/qtmultimedia,16,20,36,0.444444,0.555556
1000869,qt/qtmultimedia,2,0,2,1.000000,0.000000
1000870,qt/qtmultimedia,2,0,2,1.000000,0.000000
1001895,qt/qtmultimedia,23,18,41,0.560976,0.439024
1002416,qt/qtmultimedia,2,0,2,1.000000,0.000000
1000391,qt/qtmultimedia,4,0,4,1.000000,0.000000
1001931,qt/qtmultimedia,4,2,6,0.666667,0.333333
1001549,qt/qtmultimedia,4,1,5,0.800000,0.200000
1002219,qt/qtmultimedia,1,0,1,1.000000,0.000000
1000936,qt/qtmultimedia,24,16,40,0.600000,0.400000
1000359,qt/qtmultimedia,2,0,2,1.000000,0.000000
1001454,qt/qtmultimedia,4,0,4,1.000000,0.000000
1001967,qt/qtmultimedia,2,2,4,0.500000,0.500000
1000223,qt/qtmultimediakit,2,2,4,0.500000,0.500000
1000066,qt/qtmultimediakit,9,3,12,0.750000,0.250000
1000004,qt/qtmultimediakit,1,2,3,0.333333,0.666667
1000135,qt/qtmultimediakit,2,0,2,1.000000,0.000000
1000041,qt/qtmultimediakit,15,15,30,0.500000,0.500000
1000174,qt/qtmultimediakit,8,1,9,0.888889,0.111111
1000016,qt/qtmultimediakit,1,2,3,0.333333,0.666667
1000049,qt/qtmultimediakit,321,200,521,0.616123,0.383877
1000243,qt/qtmultimediakit,6,0,6,1.000000,0.000000
1000105,qt/qtmultimediakit,2,2,4,0.500000,0.500000
1000260,qt/qtmultimediakit,2,0,2,1.000000,0.000000
1000100,qt/qtmultimediakit,2,0,2,1.000000,0.000000
1000127,qt/qtmultimediakit,98,68,166,0.590361,0.409639
1000221,qt/qtmultimediakit,2,2,4,0.500000,0.500000
1000063,qt/qtmultimediakit,10,9,19,0.526316,0.473684
1000391,qt/qtphonon,0,2,2,0.000000,1.000000
1000327,qt/qtphonon,2,0,2,1.000000,0.000000
1000464,qt/qtphonon,2,3,5,0.400000,0.600000
1000049,qt/qtphonon,51,6,57,0.894737,0.105263
1000091,qt/qtphonon,1,0,1,1.000000,0.000000
1000063,qt/qtphonon,1,2,3,0.333333,0.666667
1001984,qt/qtpim,1,1,2,0.500000,0.500000
1000065,qt/qtpim,2,0,2,1.000000,0.000000
1000198,qt/qtpim,2,0,2,1.000000,0.000000
1000327,qt/qtpim,63,36,99,0.636364,0.363636
1000328,qt/qtpim,8,4,12,0.666667,0.333333
1000329,qt/qtpim,5,2,7,0.714286,0.285714
1000971,qt/qtpim,4,0,4,1.000000,0.000000
1000592,qt/qtpim,4,3,7,0.571429,0.428571
1000216,qt/qtpim,2,2,4,0.500000,0.500000
1000082,qt/qtpim,2,0,2,1.000000,0.000000
1002006,qt/qtpim,11,6,17,0.647059,0.352941
1000856,qt/qtpim,2,0,2,1.000000,0.000000
1000091,qt/qtpim,3,1,4,0.750000,0.250000
1002289,qt/qtpim,2,0,2,1.000000,0.000000
1000608,qt/qtpim,2,3,5,0.400000,0.600000
1000241,qt/qtpim,18,9,27,0.666667,0.333333
1000232,qt/qtpim,79,47,126,0.626984,0.373016
1000240,qt/qtpim,81,64,145,0.558621,0.441379
1000113,qt/qtpim,132,89,221,0.597285,0.402715
1000116,qt/qtpim,133,76,209,0.636364,0.363636
1000245,qt/qtpim,176,117,293,0.600683,0.399317
1000248,qt/qtpim,76,64,140,0.542857,0.457143
1000251,qt/qtpim,63,51,114,0.552632,0.447368
1000254,qt/qtpim,144,107,251,0.573705,0.426295
1000255,qt/qtpim,36,18,54,0.666667,0.333333
1000256,qt/qtpim,86,47,133,0.646617,0.353383
1000257,qt/qtpim,0,1,1,0.000000,1.000000
1000133,qt/qtpim,0,6,6,0.000000,1.000000
1000139,qt/qtpim,9,9,18,0.500000,0.500000
1002576,qt/qtpim,4,0,4,1.000000,0.000000
1002360,qt/qtpim,1,2,3,0.333333,0.666667
1000023,qt/qtpim,3,4,7,0.428571,0.571429
1000037,qt/qtpim,2,0,2,1.000000,0.000000
1000298,qt/qtpim,2,0,2,1.000000,0.000000
1002232,qt/qtpim,8,7,15,0.533333,0.466667
1000046,qt/qtpim,242,169,411,0.588808,0.411192
1000175,qt/qtpim,223,135,358,0.622905,0.377095
1000049,qt/qtpim,2072,1311,3383,0.612474,0.387526
1000054,qt/qtpim,0,4,4,0.000000,1.000000
1000312,qt/qtpim,1,0,1,1.000000,0.000000
1000185,qt/qtpim,3,0,3,1.000000,0.000000
1000063,qt/qtpim,19,18,37,0.513514,0.486486
1000064,qt/qtqa,2,6,8,0.250000,0.750000
1000578,qt/qtqa,2,0,2,1.000000,0.000000
1000329,qt/qtqa,8,5,13,0.615385,0.384615
1000331,qt/qtqa,2,0,2,1.000000,0.000000
1000205,qt/qtqa,1,3,4,0.250000,0.750000
1000078,qt/qtqa,1,0,1,1.000000,0.000000
1000084,qt/qtqa,5,0,5,1.000000,0.000000
1000093,qt/qtqa,1,3,4,0.250000,0.750000
1000098,qt/qtqa,35,6,41,0.853659,0.146341
1000100,qt/qtqa,21,13,34,0.617647,0.382353
1000111,qt/qtqa,42,18,60,0.700000,0.300000
1000112,qt/qtqa,4,0,4,1.000000,0.000000
1002377,qt/qtqa,38,7,45,0.844444,0.155556
1000129,qt/qtqa,57,29,86,0.662791,0.337209
1000130,qt/qtqa,1,0,1,1.000000,0.000000
1000971,qt/qtqa,90,17,107,0.841121,0.158879
1000004,qt/qtqa,15,6,21,0.714286,0.285714
1000054,qt/qtqa,3,1,4,0.750000,0.250000
1000134,qt/qtqa,4,0,4,1.000000,0.000000
1000014,qt/qtqa,4,0,4,1.000000,0.000000
1000016,qt/qtqa,39,28,67,0.582090,0.417910
1000530,qt/qtqa,4,0,4,1.000000,0.000000
1000023,qt/qtqa,119,46,165,0.721212,0.278788
1001949,qt/qtqa,4,8,12,0.333333,0.666667
1000166,qt/qtqa,2,0,2,1.000000,0.000000
1001454,qt/qtqa,1,0,1,1.000000,0.000000
1000049,qt/qtqa,985,420,1405,0.701068,0.298932
1000566,qt/qtqa,26,6,32,0.812500,0.187500
1000312,qt/qtqa,6,0,6,1.000000,0.000000
1002749,qt/qtqa,2,0,2,1.000000,0.000000
1000063,qt/qtqa,203,115,318,0.638365,0.361635
1000577,qt/qtquick1,7,1,8,0.875000,0.125000
1002116,qt/qtquick1,5,2,7,0.714286,0.285714
1000327,qt/qtquick1,3,3,6,0.500000,0.500000
1000008,qt/qtquick1,4,1,5,0.800000,0.200000
1000329,qt/qtquick1,19,13,32,0.593750,0.406250
1002122,qt/qtquick1,2,0,2,1.000000,0.000000
1000971,qt/qtquick1,2,0,2,1.000000,0.000000
1000592,qt/qtquick1,6,10,16,0.375000,0.625000
1000338,qt/qtquick1,2,0,2,1.000000,0.000000
1000003,qt/qtquick1,27,8,35,0.771429,0.228571
1000341,qt/qtquick1,2,0,2,1.000000,0.000000
1000516,qt/qtquick1,2,0,2,1.000000,0.000000
1000091,qt/qtquick1,4,1,5,0.800000,0.200000
1002140,qt/qtquick1,2,0,2,1.000000,0.000000
1000351,qt/qtquick1,13,9,22,0.590909,0.409091
1000096,qt/qtquick1,6,6,12,0.500000,0.500000
1000085,qt/qtquick1,2,1,3,0.666667,0.333333
1000738,qt/qtquick1,5,3,8,0.625000,0.375000
1000869,qt/qtquick1,2,0,2,1.000000,0.000000
1002289,qt/qtquick1,3,4,7,0.428571,0.571429
1000328,qt/qtquick1,2,1,3,0.666667,0.333333
1001032,qt/qtquick1,3,1,4,0.750000,0.250000
1002196,qt/qtquick1,2,0,2,1.000000,0.000000
1000118,qt/qtquick1,1,0,1,1.000000,0.000000
1001143,qt/qtquick1,22,8,30,0.733333,0.266667
1000121,qt/qtquick1,4,4,8,0.500000,0.500000
1000762,qt/qtquick1,6,11,17,0.352941,0.647059
1000765,qt/qtquick1,1,0,1,1.000000,0.000000
1002272,qt/qtquick1,16,12,28,0.571429,0.428571
1000130,qt/qtquick1,1,0,1,1.000000,0.000000
1000131,qt/qtquick1,7,4,11,0.636364,0.363636
1000004,qt/qtquick1,31,16,47,0.659574,0.340426
1000054,qt/qtquick1,7,0,7,1.000000,0.000000
1000391,qt/qtquick1,3,1,4,0.750000,0.250000
1001288,qt/qtquick1,3,2,5,0.600000,0.400000
1001419,qt/qtquick1,6,0,6,1.000000,0.000000
1000098,qt/qtquick1,8,7,15,0.533333,0.466667
1000014,qt/qtquick1,19,18,37,0.513514,0.486486
1000015,qt/qtquick1,8,3,11,0.727273,0.272727
1002232,qt/qtquick1,6,3,9,0.666667,0.333333
1000530,qt/qtquick1,2,0,2,1.000000,0.000000
1000532,qt/qtquick1,1,0,1,1.000000,0.000000
1000661,qt/qtquick1,1,0,1,1.000000,0.000000
1000023,qt/qtquick1,18,10,28,0.642857,0.357143
1000548,qt/qtquick1,4,6,10,0.400000,0.600000
1000666,qt/qtquick1,3,1,4,0.750000,0.250000
1000030,qt/qtquick1,4,5,9,0.444444,0.555556
1000164,qt/qtquick1,4,2,6,0.666667,0.333333
1000681,qt/qtquick1,0,1,1,0.000000,1.000000
1000298,qt/qtquick1,6,2,8,0.750000,0.250000
1000043,qt/qtquick1,0,2,2,0.000000,1.000000
1001454,qt/qtquick1,4,0,4,1.000000,0.000000
1000049,qt/qtquick1,885,315,1200,0.737500,0.262500
1000083,qt/qtquick1,4,6,10,0.400000,0.600000
1000822,qt/qtquick1,10,6,16,0.625000,0.375000
1000312,qt/qtquick1,2,0,2,1.000000,0.000000
1000185,qt/qtquick1,2,1,3,0.666667,0.333333
1000061,qt/qtquick1,3,5,8,0.375000,0.625000
1000063,qt/qtquick1,6,8,14,0.428571,0.571429
1002116,qt/qtquickcontrols,6,13,19,0.315789,0.684211
1000327,qt/qtquickcontrols,0,2,2,0.000000,1.000000
1000971,qt/qtquickcontrols,2,0,2,1.000000,0.000000
1001538,qt/qtquickcontrols,0,1,1,0.000000,1.000000
1000083,qt/qtquickcontrols,3,2,5,0.600000,0.400000
1000084,qt/qtquickcontrols,26,20,46,0.565217,0.434783
1000085,qt/qtquickcontrols,118,98,216,0.546296,0.453704
1002272,qt/qtquickcontrols,3,13,16,0.187500,0.812500
1000098,qt/qtquickcontrols,3,2,5,0.600000,0.400000
1000101,qt/qtquickcontrols,28,27,55,0.509091,0.490909
1002536,qt/qtquickcontrols,2,0,2,1.000000,0.000000
1001001,qt/qtquickcontrols,4,0,4,1.000000,0.000000
1002282,qt/qtquickcontrols,0,1,1,0.000000,1.000000
1000738,qt/qtquickcontrols,14,13,27,0.518519,0.481481
1000108,qt/qtquickcontrols,123,66,189,0.650794,0.349206
1000110,qt/qtquickcontrols,186,147,333,0.558559,0.441441
1002289,qt/qtquickcontrols,2,3,5,0.400000,0.600000
1000503,qt/qtquickcontrols,3,3,6,0.500000,0.500000
1000525,qt/qtquickcontrols,2,0,2,1.000000,0.000000
1000121,qt/qtquickcontrols,3,2,5,0.600000,0.400000
1000973,qt/qtquickcontrols,2,0,2,1.000000,0.000000
1000765,qt/qtquickcontrols,4,2,6,0.666667,0.333333
1000130,qt/qtquickcontrols,24,22,46,0.521739,0.478261
1000003,qt/qtquickcontrols,4,3,7,0.571429,0.428571
1000004,qt/qtquickcontrols,39,15,54,0.722222,0.277778
1000012,qt/qtquickcontrols,2,0,2,1.000000,0.000000
1001419,qt/qtquickcontrols,10,8,18,0.555556,0.444444
1000140,qt/qtquickcontrols,159,113,272,0.584559,0.415441
1000141,qt/qtquickcontrols,8,0,8,1.000000,0.000000
1000014,qt/qtquickcontrols,14,6,20,0.700000,0.300000
1000077,qt/qtquickcontrols,2,2,4,0.500000,0.500000
1000530,qt/qtquickcontrols,1,0,1,1.000000,0.000000
1000405,qt/qtquickcontrols,4,0,4,1.000000,0.000000
1000023,qt/qtquickcontrols,2,0,2,1.000000,0.000000
1001572,qt/qtquickcontrols,20,9,29,0.689655,0.310345
1000036,qt/qtquickcontrols,5,0,5,1.000000,0.000000
1000166,qt/qtquickcontrols,3,4,7,0.428571,0.571429
1002600,qt/qtquickcontrols,4,1,5,0.800000,0.200000
1000298,qt/qtquickcontrols,14,15,29,0.482759,0.517241
1000043,qt/qtquickcontrols,2,0,2,1.000000,0.000000
1001967,qt/qtquickcontrols,1,5,6,0.166667,0.833333
1000049,qt/qtquickcontrols,2685,1778,4463,0.601613,0.398387
1000054,qt/qtquickcontrols,63,30,93,0.677419,0.322581
1000105,qt/qtquickcontrols,7,12,19,0.368421,0.631579
1000312,qt/qtquickcontrols,20,6,26,0.769231,0.230769
1000061,qt/qtquickcontrols,3,8,11,0.272727,0.727273
1000004,qt/qtquickcontrols-tizen,1,0,1,1.000000,0.000000
1002600,qt/qtquickcontrols-tizen,2,0,2,1.000000,0.000000
1002282,qt/qtquickcontrols-tizen,10,5,15,0.666667,0.333333
1002607,qt/qtquickcontrols-tizen,2,0,2,1.000000,0.000000
1000049,qt/qtquickcontrols-tizen,106,45,151,0.701987,0.298013
1000023,qt/qtquickcontrols-tizen,1,0,1,1.000000,0.000000
1000708,qt/qtrepotools,4,3,7,0.571429,0.428571
1000329,qt/qtrepotools,13,4,17,0.764706,0.235294
1000971,qt/qtrepotools,2,0,2,1.000000,0.000000
1000592,qt/qtrepotools,4,2,6,0.666667,0.333333
1001796,qt/qtrepotools,2,0,2,1.000000,0.000000
1000091,qt/qtrepotools,8,7,15,0.533333,0.466667
1000093,qt/qtrepotools,2,0,2,1.000000,0.000000
1000098,qt/qtrepotools,39,19,58,0.672414,0.327586
1000100,qt/qtrepotools,26,22,48,0.541667,0.458333
1002151,qt/qtrepotools,2,7,9,0.222222,0.777778
1002377,qt/qtrepotools,1,0,1,1.000000,0.000000
1000121,qt/qtrepotools,14,1,15,0.933333,0.066667
1000130,qt/qtrepotools,5,10,15,0.333333,0.666667
1000003,qt/qtrepotools,0,2,2,0.000000,1.000000
1000004,qt/qtrepotools,88,25,113,0.778761,0.221239
1000054,qt/qtrepotools,2,0,2,1.000000,0.000000
1000014,qt/qtrepotools,49,18,67,0.731343,0.268657
1000023,qt/qtrepotools,22,3,25,0.880000,0.120000
1000032,qt/qtrepotools,5,0,5,1.000000,0.000000
1000164,qt/qtrepotools,2,0,2,1.000000,0.000000
1000681,qt/qtrepotools,7,1,8,0.875000,0.125000
1000173,qt/qtrepotools,1,0,1,1.000000,0.000000
1001454,qt/qtrepotools,21,4,25,0.840000,0.160000
1000049,qt/qtrepotools,565,245,810,0.697531,0.302469
1000053,qt/qtrepotools,4,2,6,0.666667,0.333333
1000822,qt/qtrepotools,2,0,2,1.000000,0.000000
1000312,qt/qtrepotools,1,0,1,1.000000,0.000000
1001982,qt/qtrepotools,16,3,19,0.842105,0.157895
1000063,qt/qtrepotools,2,5,7,0.285714,0.714286
1001857,qt/qtscript,4,0,4,1.000000,0.000000
1000708,qt/qtscript,2,1,3,0.666667,0.333333
1000822,qt/qtscript,6,0,6,1.000000,0.000000
1002374,qt/qtscript,2,0,2,1.000000,0.000000
1000577,qt/qtscript,8,0,8,1.000000,0.000000
1000328,qt/qtscript,13,9,22,0.590909,0.409091
1000329,qt/qtscript,2,0,2,1.000000,0.000000
1000971,qt/qtscript,3,2,5,0.600000,0.400000
1000972,qt/qtscript,2,0,2,1.000000,0.000000
1000387,qt/qtscript,2,0,2,1.000000,0.000000
1000091,qt/qtscript,13,6,19,0.684211,0.315789
1002289,qt/qtscript,3,0,3,1.000000,0.000000
1000098,qt/qtscript,2,0,2,1.000000,0.000000
1000100,qt/qtscript,1,2,3,0.333333,0.666667
1000870,qt/qtscript,2,0,2,1.000000,0.000000
1000359,qt/qtscript,2,2,4,0.500000,0.500000
1001032,qt/qtscript,0,2,2,0.000000,1.000000
1000120,qt/qtscript,5,2,7,0.714286,0.285714
1000121,qt/qtscript,2,0,2,1.000000,0.000000
1000129,qt/qtscript,3,3,6,0.500000,0.500000
1000203,qt/qtscript,4,4,8,0.500000,0.500000
1000004,qt/qtscript,8,4,12,0.666667,0.333333
1000005,qt/qtscript,1,0,1,1.000000,0.000000
1000391,qt/qtscript,1,0,1,1.000000,0.000000
1001288,qt/qtscript,2,0,2,1.000000,0.000000
1001419,qt/qtscript,1,0,1,1.000000,0.000000
1000014,qt/qtscript,5,0,5,1.000000,0.000000
1001039,qt/qtscript,2,0,2,1.000000,0.000000
1000016,qt/qtscript,2,0,2,1.000000,0.000000
1000023,qt/qtscript,5,0,5,1.000000,0.000000
1000015,qt/qtscript,2,0,2,1.000000,0.000000
1000155,qt/qtscript,1,2,3,0.333333,0.666667
1000271,qt/qtscript,1,0,1,1.000000,0.000000
1000548,qt/qtscript,2,0,2,1.000000,0.000000
1000166,qt/qtscript,2,0,2,1.000000,0.000000
1000681,qt/qtscript,6,0,6,1.000000,0.000000
1000298,qt/qtscript,2,0,2,1.000000,0.000000
1001454,qt/qtscript,4,0,4,1.000000,0.000000
1000049,qt/qtscript,562,129,691,0.813314,0.186686
1000003,qt/qtscript,2,2,4,0.500000,0.500000
1000054,qt/qtscript,1,4,5,0.200000,0.800000
1002359,qt/qtscript,2,0,2,1.000000,0.000000
1001982,qt/qtscript,2,0,2,1.000000,0.000000
1000063,qt/qtscript,8,12,20,0.400000,0.600000
1001984,qt/qtsensors,25,24,49,0.510204,0.489796
1000448,qt/qtsensors,3,2,5,0.600000,0.400000
1000198,qt/qtsensors,7,4,11,0.636364,0.363636
1000327,qt/qtsensors,0,2,2,0.000000,1.000000
1000329,qt/qtsensors,1,2,3,0.333333,0.666667
1000971,qt/qtsensors,2,0,2,1.000000,0.000000
1002113,qt/qtsensors,3,0,3,1.000000,0.000000
1000077,qt/qtsensors,3,2,5,0.600000,0.400000
1000592,qt/qtsensors,2,0,2,1.000000,0.000000
1000132,qt/qtsensors,9,12,21,0.428571,0.571429
1000213,qt/qtsensors,3,1,4,0.750000,0.250000
1002006,qt/qtsensors,8,2,10,0.800000,0.200000
1002137,qt/qtsensors,2,0,2,1.000000,0.000000
1000004,qt/qtsensors,17,12,29,0.586207,0.413793
1000516,qt/qtsensors,11,8,19,0.578947,0.421053
1000097,qt/qtsensors,145,105,250,0.580000,0.420000
1000738,qt/qtsensors,2,0,2,1.000000,0.000000
1000100,qt/qtsensors,3,4,7,0.428571,0.571429
1000869,qt/qtsensors,17,22,39,0.435897,0.564103
1002289,qt/qtsensors,4,0,4,1.000000,0.000000
1000071,qt/qtsensors,6,6,12,0.500000,0.500000
1001775,qt/qtsensors,3,2,5,0.600000,0.400000
1001288,qt/qtsensors,2,1,3,0.666667,0.333333
1000008,qt/qtsensors,3,3,6,0.500000,0.500000
1000118,qt/qtsensors,1,2,3,0.333333,0.666667
1000119,qt/qtsensors,2,0,2,1.000000,0.000000
1000121,qt/qtsensors,36,2,38,0.947368,0.052632
1000250,qt/qtsensors,28,27,55,0.509091,0.490909
1002176,qt/qtsensors,19,9,28,0.678571,0.321429
1001419,qt/qtsensors,6,4,10,0.600000,0.400000
1000260,qt/qtsensors,6,4,10,0.600000,0.400000
1000133,qt/qtsensors,31,7,38,0.815789,0.184211
1000136,qt/qtsensors,69,57,126,0.547619,0.452381
1001931,qt/qtsensors,7,1,8,0.875000,0.125000
1000014,qt/qtsensors,4,0,4,1.000000,0.000000
1000503,qt/qtsensors,2,3,5,0.400000,0.600000
1000661,qt/qtsensors,18,7,25,0.720000,0.280000
1000023,qt/qtsensors,4,0,4,1.000000,0.000000
1001380,qt/qtsensors,4,3,7,0.571429,0.428571
1000762,qt/qtsensors,101,75,176,0.573864,0.426136
1000032,qt/qtsensors,4,3,7,0.571429,0.428571
1001953,qt/qtsensors,37,49,86,0.430233,0.569767
1000034,qt/qtsensors,1,4,5,0.200000,0.800000
1000036,qt/qtsensors,13,13,26,0.500000,0.500000
1000298,qt/qtsensors,12,5,17,0.705882,0.294118
1001836,qt/qtsensors,20,10,30,0.666667,0.333333
1002607,qt/qtsensors,2,4,6,0.333333,0.666667
1001840,qt/qtsensors,9,4,13,0.692308,0.307692
1000049,qt/qtsensors,1411,622,2033,0.694048,0.305952
1000054,qt/qtsensors,7,3,10,0.700000,0.300000
1000312,qt/qtsensors,10,5,15,0.666667,0.333333
1000063,qt/qtsensors,6,3,9,0.666667,0.333333
1000448,qt/qtserialport,0,2,2,0.000000,1.000000
1000070,qt/qtserialport,1,2,3,0.333333,0.666667
1000329,qt/qtserialport,18,11,29,0.620690,0.379310
1002251,qt/qtserialport,2,0,2,1.000000,0.000000
1000207,qt/qtserialport,2,0,2,1.000000,0.000000
1001623,qt/qtserialport,30,14,44,0.681818,0.318182
1002272,qt/qtserialport,2,0,2,1.000000,0.000000
1000098,qt/qtserialport,8,0,8,1.000000,0.000000
1000744,qt/qtserialport,6,0,6,1.000000,0.000000
1000503,qt/qtserialport,2,2,4,0.500000,0.500000
1000121,qt/qtserialport,1,2,3,0.333333,0.666667
1000003,qt/qtserialport,2,2,4,0.500000,0.500000
1000004,qt/qtserialport,3,3,6,0.500000,0.500000
1000054,qt/qtserialport,10,6,16,0.625000,0.375000
1001419,qt/qtserialport,1,0,1,1.000000,0.000000
1000014,qt/qtserialport,2,4,6,0.333333,0.666667
1000528,qt/qtserialport,5,1,6,0.833333,0.166667
1000530,qt/qtserialport,5,0,5,1.000000,0.000000
1002068,qt/qtserialport,25,12,37,0.675676,0.324324
1002581,qt/qtserialport,5,2,7,0.714286,0.285714
1000023,qt/qtserialport,1,0,1,1.000000,0.000000
1000413,qt/qtserialport,507,260,767,0.661017,0.338983
1002192,qt/qtserialport,2,0,2,1.000000,0.000000
1001572,qt/qtserialport,6,2,8,0.750000,0.250000
1000298,qt/qtserialport,2,8,10,0.200000,0.800000
1001195,qt/qtserialport,2,0,2,1.000000,0.000000
1000942,qt/qtserialport,200,98,298,0.671141,0.328859
1002224,qt/qtserialport,2,1,3,0.666667,0.333333
1000049,qt/qtserialport,821,742,1563,0.525272,0.474728
1002358,qt/qtserialport,0,5,5,0.000000,1.000000
1000312,qt/qtserialport,492,173,665,0.739850,0.260150
1002495,qt/qtserialport,2,2,4,0.500000,0.500000
1000049,qt/qtstyleplugins,33,11,44,0.750000,0.250000
1000004,qt/qtstyleplugins,2,0,2,1.000000,0.000000
1000140,qt/qtstyleplugins,4,10,14,0.285714,0.714286
1000101,qt/qtstyleplugins,12,10,22,0.545455,0.454545
1000023,qt/qtstyleplugins,3,0,3,1.000000,0.000000
1001857,qt/qtsvg,2,0,2,1.000000,0.000000
1000324,qt/qtsvg,1,0,1,1.000000,0.000000
1000327,qt/qtsvg,2,0,2,1.000000,0.000000
1000329,qt/qtsvg,0,1,1,0.000000,1.000000
1000971,qt/qtsvg,2,0,2,1.000000,0.000000
1000464,qt/qtsvg,2,0,2,1.000000,0.000000
1000100,qt/qtsvg,2,0,2,1.000000,0.000000
1000870,qt/qtsvg,2,0,2,1.000000,0.000000
1002289,qt/qtsvg,3,1,4,0.750000,0.250000
1000120,qt/qtsvg,0,2,2,0.000000,1.000000
1000331,qt/qtsvg,2,0,2,1.000000,0.000000
1000004,qt/qtsvg,11,13,24,0.458333,0.541667
1000005,qt/qtsvg,0,2,2,0.000000,1.000000
1000577,qt/qtsvg,6,0,6,1.000000,0.000000
1001419,qt/qtsvg,1,0,1,1.000000,0.000000
1000014,qt/qtsvg,3,2,5,0.600000,0.400000
1000023,qt/qtsvg,3,2,5,0.600000,0.400000
1000548,qt/qtsvg,0,2,2,0.000000,1.000000
1000681,qt/qtsvg,0,3,3,0.000000,1.000000
1001454,qt/qtsvg,4,0,4,1.000000,0.000000
1000049,qt/qtsvg,319,75,394,0.809645,0.190355
1000054,qt/qtsvg,8,6,14,0.571429,0.428571
1001982,qt/qtsvg,2,0,2,1.000000,0.000000
1000063,qt/qtsvg,4,2,6,0.666667,0.333333
1000064,qt/qtsystems,3,1,4,0.750000,0.250000
1001984,qt/qtsystems,0,1,1,0.000000,1.000000
1000198,qt/qtsystems,4,0,4,1.000000,0.000000
1000257,qt/qtsystems,1,0,1,1.000000,0.000000
1000329,qt/qtsystems,4,2,6,0.666667,0.333333
1000971,qt/qtsystems,2,0,2,1.000000,0.000000
1000082,qt/qtsystems,11,4,15,0.733333,0.266667
1000213,qt/qtsystems,2,0,2,1.000000,0.000000
1002006,qt/qtsystems,27,33,60,0.450000,0.550000
1000219,qt/qtsystems,84,49,133,0.631579,0.368421
1002012,qt/qtsystems,7,0,7,1.000000,0.000000
1000097,qt/qtsystems,17,9,26,0.653846,0.346154
1000738,qt/qtsystems,2,1,3,0.666667,0.333333
1002150,qt/qtsystems,1,0,1,1.000000,0.000000
1002289,qt/qtsystems,0,3,3,0.000000,1.000000
1000233,qt/qtsystems,36,21,57,0.631579,0.368421
1000136,qt/qtsystems,9,8,17,0.529412,0.470588
1000116,qt/qtsystems,84,56,140,0.600000,0.400000
1001401,qt/qtsystems,3,1,4,0.750000,0.250000
1000251,qt/qtsystems,9,4,13,0.692308,0.307692
1000127,qt/qtsystems,3,1,4,0.750000,0.250000
1000128,qt/qtsystems,3,2,5,0.600000,0.400000
1000129,qt/qtsystems,2,0,2,1.000000,0.000000
1000003,qt/qtsystems,4,1,5,0.800000,0.200000
1000133,qt/qtsystems,32,35,67,0.477612,0.522388
1000391,qt/qtsystems,5,2,7,0.714286,0.285714
1000008,qt/qtsystems,11,2,13,0.846154,0.153846
1000010,qt/qtsystems,4,0,4,1.000000,0.000000
1000014,qt/qtsystems,4,2,6,0.666667,0.333333
1000144,qt/qtsystems,8,1,9,0.888889,0.111111
1000146,qt/qtsystems,42,19,61,0.688525,0.311475
1002197,qt/qtsystems,2,4,6,0.333333,0.666667
1000023,qt/qtsystems,6,1,7,0.857143,0.142857
1000029,qt/qtsystems,4,5,9,0.444444,0.555556
1000037,qt/qtsystems,11,8,19,0.578947,0.421053
1000934,qt/qtsystems,11,2,13,0.846154,0.153846
1000298,qt/qtsystems,2,0,2,1.000000,0.000000
1000046,qt/qtsystems,49,36,85,0.576471,0.423529
1000049,qt/qtsystems,1222,533,1755,0.696296,0.303704
1000050,qt/qtsystems,1,0,1,1.000000,0.000000
1000053,qt/qtsystems,3,4,7,0.428571,0.571429
1000823,qt/qtsystems,22,8,30,0.733333,0.266667
1000312,qt/qtsystems,3,2,5,0.600000,0.400000
1002111,qt/qtsystems,2,0,2,1.000000,0.000000
1000063,qt/qtsystems,10,6,16,0.625000,0.375000
1000448,qt/qttools,7,5,12,0.583333,0.416667
1000577,qt/qttools,6,0,6,1.000000,0.000000
1000199,qt/qttools,12,11,23,0.521739,0.478261
1000329,qt/qttools,14,13,27,0.518519,0.481481
1000971,qt/qttools,2,0,2,1.000000,0.000000
1000077,qt/qttools,0,2,2,0.000000,1.000000
1000334,qt/qttools,19,2,21,0.904762,0.095238
1000592,qt/qttools,9,11,20,0.450000,0.550000
1000338,qt/qttools,3,5,8,0.375000,0.625000
1000083,qt/qttools,2,1,3,0.666667,0.333333
1000132,qt/qttools,6,7,13,0.461538,0.538462
1000341,qt/qttools,4,2,6,0.666667,0.333333
1000503,qt/qttools,2,2,4,0.500000,0.500000
1001931,qt/qttools,2,0,2,1.000000,0.000000
1000738,qt/qttools,2,3,5,0.400000,0.600000
1000100,qt/qttools,3,4,7,0.428571,0.571429
1000869,qt/qttools,2,0,2,1.000000,0.000000
1000870,qt/qttools,22,3,25,0.880000,0.120000
1000359,qt/qttools,4,0,4,1.000000,0.000000
1000105,qt/qttools,1,0,1,1.000000,0.000000
1000108,qt/qttools,8,4,12,0.666667,0.333333
1000110,qt/qttools,6,0,6,1.000000,0.000000
1002289,qt/qttools,2,0,2,1.000000,0.000000
1001910,qt/qttools,2,1,3,0.666667,0.333333
1000119,qt/qttools,2,1,3,0.666667,0.333333
1000120,qt/qttools,6,3,9,0.666667,0.333333
1000121,qt/qttools,6,4,10,0.600000,0.400000
1000011,qt/qttools,2,2,4,0.500000,0.500000
1000126,qt/qttools,3,1,4,0.750000,0.250000
1000130,qt/qttools,1,0,1,1.000000,0.000000
1000003,qt/qttools,11,5,16,0.687500,0.312500
1000004,qt/qttools,166,85,251,0.661355,0.338645
1000822,qt/qttools,4,2,6,0.666667,0.333333
1000007,qt/qttools,35,22,57,0.614035,0.385965
1000008,qt/qttools,20,8,28,0.714286,0.285714
1001419,qt/qttools,0,1,1,0.000000,1.000000
1000014,qt/qttools,65,42,107,0.607477,0.392523
1000015,qt/qttools,136,19,155,0.877419,0.122581
1000912,qt/qttools,2,1,3,0.666667,0.333333
1000401,qt/qttools,0,5,5,0.000000,1.000000
1000018,qt/qttools,4,4,8,0.500000,0.500000
1000023,qt/qttools,14,9,23,0.608696,0.391304
1001572,qt/qttools,7,4,11,0.636364,0.363636
1000153,qt/qttools,2,0,2,1.000000,0.000000
1000026,qt/qttools,21,14,35,0.600000,0.400000
1000155,qt/qttools,1,2,3,0.333333,0.666667
1000530,qt/qttools,1,0,1,1.000000,0.000000
1000101,qt/qttools,3,2,5,0.600000,0.400000
1002000,qt/qttools,2,0,2,1.000000,0.000000
1000833,qt/qttools,1,0,1,1.000000,0.000000
1000036,qt/qttools,2,0,2,1.000000,0.000000
1001190,qt/qttools,8,5,13,0.615385,0.384615
1002344,qt/qttools,1,0,1,1.000000,0.000000
1000681,qt/qttools,6,1,7,0.857143,0.142857
1000810,qt/qttools,8,4,12,0.666667,0.333333
1000043,qt/qttools,2,0,2,1.000000,0.000000
1000045,qt/qttools,4,5,9,0.444444,0.555556
1001454,qt/qttools,4,0,4,1.000000,0.000000
1001967,qt/qttools,2,0,2,1.000000,0.000000
1000049,qt/qttools,1760,597,2357,0.746712,0.253288
1001026,qt/qttools,2,0,2,1.000000,0.000000
1000053,qt/qttools,2,0,2,1.000000,0.000000
1000054,qt/qttools,17,16,33,0.515152,0.484848
1001975,qt/qttools,2,0,2,1.000000,0.000000
1000312,qt/qttools,11,2,13,0.846154,0.153846
1000057,qt/qttools,10,2,12,0.833333,0.166667
1000063,qt/qttools,19,14,33,0.575758,0.424242
1000298,qt/qttools,2,1,3,0.666667,0.333333
1000831,qt/qttools,2,2,4,0.500000,0.500000
1000577,qt/qttranslations,2,0,2,1.000000,0.000000
1000329,qt/qttranslations,2,0,2,1.000000,0.000000
1000971,qt/qttranslations,2,0,2,1.000000,0.000000
1000942,qt/qttranslations,4,0,4,1.000000,0.000000
1000153,qt/qttranslations,2,0,2,1.000000,0.000000
1000101,qt/qttranslations,1,2,3,0.333333,0.666667
1002031,qt/qttranslations,1,5,6,0.166667,0.833333
1000496,qt/qttranslations,2,0,2,1.000000,0.000000
1002289,qt/qttranslations,3,4,7,0.428571,0.571429
1002424,qt/qttranslations,3,3,6,0.500000,0.500000
1002432,qt/qttranslations,11,3,14,0.785714,0.214286
1002051,qt/qttranslations,2,0,2,1.000000,0.000000
1000004,qt/qttranslations,37,28,65,0.569231,0.430769
1000013,qt/qttranslations,14,7,21,0.666667,0.333333
1000014,qt/qttranslations,16,4,20,0.800000,0.200000
1002320,qt/qttranslations,8,5,13,0.615385,0.384615
1000120,qt/qttranslations,2,0,2,1.000000,0.000000
1000023,qt/qttranslations,5,0,5,1.000000,0.000000
1000548,qt/qttranslations,8,4,12,0.666667,0.333333
1000413,qt/qttranslations,10,4,14,0.714286,0.285714
1002340,qt/qttranslations,2,0,2,1.000000,0.000000
1000173,qt/qttranslations,4,3,7,0.571429,0.428571
1001454,qt/qttranslations,4,0,4,1.000000,0.000000
1000049,qt/qttranslations,188,104,292,0.643836,0.356164
1000307,qt/qttranslations,2,0,2,1.000000,0.000000
1000565,qt/qttranslations,7,7,14,0.500000,0.500000
1000063,qt/qttranslations,2,4,6,0.333333,0.666667
1000068,qt/qtwayland,13,9,22,0.590909,0.409091
1000070,qt/qtwayland,22,21,43,0.511628,0.488372
1000329,qt/qtwayland,3,1,4,0.750000,0.250000
1000971,qt/qtwayland,2,1,3,0.666667,0.333333
1000464,qt/qtwayland,5,5,10,0.500000,0.500000
1000472,qt/qtwayland,4,1,5,0.800000,0.200000
1002268,qt/qtwayland,10,5,15,0.666667,0.333333
1002657,qt/qtwayland,60,20,80,0.750000,0.250000
1002160,qt/qtwayland,10,0,10,1.000000,0.000000
1002289,qt/qtwayland,1,0,1,1.000000,0.000000
1000120,qt/qtwayland,2,0,2,1.000000,0.000000
1000123,qt/qtwayland,40,27,67,0.597015,0.402985
1001663,qt/qtwayland,2,0,2,1.000000,0.000000
1002050,qt/qtwayland,2,0,2,1.000000,0.000000
1000075,qt/qtwayland,22,34,56,0.392857,0.607143
1000004,qt/qtwayland,4,0,4,1.000000,0.000000
1002054,qt/qtwayland,4,3,7,0.571429,0.428571
1001032,qt/qtwayland,4,2,6,0.666667,0.333333
1000532,qt/qtwayland,2,2,4,0.500000,0.500000
1000023,qt/qtwayland,1,2,3,0.333333,0.666667
1000025,qt/qtwayland,2,0,2,1.000000,0.000000
1000032,qt/qtwayland,2,1,3,0.666667,0.333333
1000036,qt/qtwayland,14,9,23,0.608696,0.391304
1001190,qt/qtwayland,24,3,27,0.888889,0.111111
1002600,qt/qtwayland,2,1,3,0.666667,0.333333
1000049,qt/qtwayland,1309,420,1729,0.757085,0.242915
1001079,qt/qtwayland,42,12,54,0.777778,0.222222
1000312,qt/qtwayland,2,0,2,1.000000,0.000000
1000193,qt/qtwebkit,26,9,35,0.742857,0.257143
1000577,qt/qtwebkit,4,0,4,1.000000,0.000000
1000329,qt/qtwebkit,6,1,7,0.857143,0.142857
1000971,qt/qtwebkit,2,0,2,1.000000,0.000000
1000083,qt/qtwebkit,2,1,3,0.666667,0.333333
1002137,qt/qtwebkit,2,0,2,1.000000,0.000000
1002142,qt/qtwebkit,2,0,2,1.000000,0.000000
1000738,qt/qtwebkit,5,1,6,0.833333,0.166667
1000391,qt/qtwebkit,5,2,7,0.714286,0.285714
1001132,qt/qtwebkit,44,23,67,0.656716,0.343284
1001277,qt/qtwebkit,1,0,1,1.000000,0.000000
1000130,qt/qtwebkit,1,2,3,0.333333,0.666667
1000003,qt/qtwebkit,1,2,3,0.333333,0.666667
1000004,qt/qtwebkit,6,1,7,0.857143,0.142857
1000005,qt/qtwebkit,20,13,33,0.606061,0.393939
1000263,qt/qtwebkit,10,4,14,0.714286,0.285714
1000010,qt/qtwebkit,4,3,7,0.571429,0.428571
1000013,qt/qtwebkit,1,0,1,1.000000,0.000000
1000014,qt/qtwebkit,3,0,3,1.000000,0.000000
1000015,qt/qtwebkit,4,2,6,0.666667,0.333333
1002705,qt/qtwebkit,2,0,2,1.000000,0.000000
1000530,qt/qtwebkit,1,0,1,1.000000,0.000000
1002197,qt/qtwebkit,1,0,1,1.000000,0.000000
1000023,qt/qtwebkit,5,3,8,0.625000,0.375000
1000153,qt/qtwebkit,4,0,4,1.000000,0.000000
1002078,qt/qtwebkit,1,0,1,1.000000,0.000000
1000032,qt/qtwebkit,10,1,11,0.909091,0.090909
1000298,qt/qtwebkit,1,0,1,1.000000,0.000000
1001454,qt/qtwebkit,4,0,4,1.000000,0.000000
1000049,qt/qtwebkit,809,384,1193,0.678122,0.321878
1000307,qt/qtwebkit,5,0,5,1.000000,0.000000
1000181,qt/qtwebkit,1,0,1,1.000000,0.000000
1000054,qt/qtwebkit,2,4,6,0.333333,0.666667
1000312,qt/qtwebkit,3,2,5,0.600000,0.400000
1000577,qt/qtwebkit-examples,6,0,6,1.000000,0.000000
1000130,qt/qtwebkit-examples,2,2,4,0.500000,0.500000
1000004,qt/qtwebkit-examples,0,4,4,0.000000,1.000000
1000005,qt/qtwebkit-examples,6,1,7,0.857143,0.142857
1000263,qt/qtwebkit-examples,17,6,23,0.739130,0.260870
1000971,qt/qtwebkit-examples,2,0,2,1.000000,0.000000
1001454,qt/qtwebkit-examples,6,0,6,1.000000,0.000000
1000015,qt/qtwebkit-examples,2,0,2,1.000000,0.000000
1000049,qt/qtwebkit-examples,243,58,301,0.807309,0.192691
1000307,qt/qtwebkit-examples,3,3,6,0.500000,0.500000
1000083,qt/qtwebkit-examples,3,1,4,0.750000,0.250000
1000181,qt/qtwebkit-examples,2,3,5,0.400000,0.600000
1000054,qt/qtwebkit-examples,5,2,7,0.714286,0.285714
1000023,qt/qtwebkit-examples,4,1,5,0.800000,0.200000
1000193,qt/qtwebkit-examples,1,0,1,1.000000,0.000000
1002289,qt/qtwebkit-examples,1,0,1,1.000000,0.000000
1000064,qt/qtwebkit-examples-and-demos,1,2,3,0.333333,0.666667
1000049,qt/qtwebkit-examples-and-demos,22,6,28,0.785714,0.214286
1000129,qt/qtwebkit-examples-and-demos,2,0,2,1.000000,0.000000
1000548,qt/qtwebkit-examples-and-demos,1,2,3,0.333333,0.666667
1000063,qt/qtwebkit-examples-and-demos,1,2,3,0.333333,0.666667
1002272,qt/qtwinextras,2,0,2,1.000000,0.000000
1000043,qt/qtwinextras,4,0,4,1.000000,0.000000
1000004,qt/qtwinextras,11,3,14,0.785714,0.214286
1000101,qt/qtwinextras,13,7,20,0.650000,0.350000
1002184,qt/qtwinextras,149,40,189,0.788360,0.211640
1000329,qt/qtwinextras,2,0,2,1.000000,0.000000
1000298,qt/qtwinextras,7,1,8,0.875000,0.125000
1000120,qt/qtwinextras,9,13,22,0.409091,0.590909
1000140,qt/qtwinextras,22,6,28,0.785714,0.214286
1000014,qt/qtwinextras,94,45,139,0.676259,0.323741
1000592,qt/qtwinextras,2,0,2,1.000000,0.000000
1000049,qt/qtwinextras,315,133,448,0.703125,0.296875
1000530,qt/qtwinextras,93,12,105,0.885714,0.114286
1001419,qt/qtwinextras,1,0,1,1.000000,0.000000
1000085,qt/qtwinextras,18,12,30,0.600000,0.400000
1000023,qt/qtwinextras,4,2,6,0.666667,0.333333
1000312,qt/qtwinextras,65,7,72,0.902778,0.097222
1000008,qt/qtwinextras,3,4,7,0.428571,0.571429
1000026,qt/qtwinextras,20,11,31,0.645161,0.354839
1002749,qt/qtwinextras,2,0,2,1.000000,0.000000
1000098,qt/qtx11extras,2,0,2,1.000000,0.000000
1001419,qt/qtx11extras,1,0,1,1.000000,0.000000
1000004,qt/qtx11extras,2,0,2,1.000000,0.000000
1000331,qt/qtx11extras,3,2,5,0.600000,0.400000
1000014,qt/qtx11extras,1,1,2,0.500000,0.500000
1000049,qt/qtx11extras,87,28,115,0.756522,0.243478
1000334,qt/qtx11extras,5,4,9,0.555556,0.444444
1000312,qt/qtx11extras,4,1,5,0.800000,0.200000
1000831,qt/qtx11extras,4,3,7,0.571429,0.428571
1000833,qt/qtxmlpatterns,1,2,3,0.333333,0.666667
1000327,qt/qtxmlpatterns,2,1,3,0.666667,0.333333
1000329,qt/qtxmlpatterns,3,0,3,1.000000,0.000000
1000971,qt/qtxmlpatterns,1,0,1,1.000000,0.000000
1000100,qt/qtxmlpatterns,1,2,3,0.333333,0.666667
1002160,qt/qtxmlpatterns,3,1,4,0.750000,0.250000
1002289,qt/qtxmlpatterns,2,0,2,1.000000,0.000000
1001026,qt/qtxmlpatterns,3,2,5,0.600000,0.400000
1000004,qt/qtxmlpatterns,5,11,16,0.312500,0.687500
1000391,qt/qtxmlpatterns,2,0,2,1.000000,0.000000
1000577,qt/qtxmlpatterns,8,0,8,1.000000,0.000000
1000014,qt/qtxmlpatterns,6,2,8,0.750000,0.250000
1000015,qt/qtxmlpatterns,1,0,1,1.000000,0.000000
1000312,qt/qtxmlpatterns,3,0,3,1.000000,0.000000
1000278,qt/qtxmlpatterns,2,0,2,1.000000,0.000000
1000023,qt/qtxmlpatterns,13,1,14,0.928571,0.071429
1000548,qt/qtxmlpatterns,4,0,4,1.000000,0.000000
1000298,qt/qtxmlpatterns,4,0,4,1.000000,0.000000
1001454,qt/qtxmlpatterns,6,0,6,1.000000,0.000000
1001967,qt/qtxmlpatterns,2,0,2,1.000000,0.000000
1000049,qt/qtxmlpatterns,413,94,507,0.814596,0.185404
1001716,qt/qtxmlpatterns,1,0,1,1.000000,0.000000
1002360,qt/qtxmlpatterns,2,0,2,1.000000,0.000000
1000319,qt/qtxmlpatterns,2,0,2,1.000000,0.000000
1001982,qt/qtxmlpatterns,2,0,2,1.000000,0.000000
1000063,qt/qtxmlpatterns,11,16,27,0.407407,0.592593
1000548,qt/quick3d,1,0,1,1.000000,0.000000
1000194,qt/quick3d,49,22,71,0.690141,0.309859
1000835,qt/quick3d,6,3,9,0.666667,0.333333
1000100,qt/quick3d,6,0,6,1.000000,0.000000
1000177,qt/quick3d,15,12,27,0.555556,0.444444
1000171,qt/quick3d,38,11,49,0.775510,0.224490
1000176,qt/quick3d,7,2,9,0.777778,0.222222
1000049,qt/quick3d,727,402,1129,0.643933,0.356067
1000179,qt/quick3d,10,10,20,0.500000,0.500000
1000327,qt/quick3d,12,10,22,0.545455,0.454545
1000023,qt/quick3d,5,1,6,0.833333,0.166667
1000881,qt/quick3d,50,33,83,0.602410,0.397590
1000004,qt/quick3d,6,7,13,0.461538,0.538462
1000063,qt/quick3d,12,4,16,0.750000,0.250000
1000577,qtsdk/qtsdk,4,2,6,0.666667,0.333333
1000578,qtsdk/qtsdk,2,0,2,1.000000,0.000000
1000199,qtsdk/qtsdk,5,1,6,0.833333,0.166667
1000329,qtsdk/qtsdk,3,2,5,0.600000,0.400000
1000971,qtsdk/qtsdk,3,1,4,0.750000,0.250000
1000076,qtsdk/qtsdk,6,0,6,1.000000,0.000000
1000338,qtsdk/qtsdk,2,0,2,1.000000,0.000000
1000085,qtsdk/qtsdk,0,2,2,0.000000,1.000000
1000132,qtsdk/qtsdk,12,3,15,0.800000,0.200000
1000410,qtsdk/qtsdk,0,2,2,0.000000,1.000000
1000005,qtsdk/qtsdk,2,0,2,1.000000,0.000000
1000098,qtsdk/qtsdk,17,5,22,0.772727,0.227273
1001764,qtsdk/qtsdk,3,11,14,0.214286,0.785714
1002536,qtsdk/qtsdk,30,5,35,0.857143,0.142857
1000007,qtsdk/qtsdk,1,3,4,0.250000,0.750000
1000109,qtsdk/qtsdk,32,19,51,0.627451,0.372549
1000110,qtsdk/qtsdk,2,0,2,1.000000,0.000000
1002930,qtsdk/qtsdk,3,9,12,0.250000,0.750000
1002377,qtsdk/qtsdk,6,0,6,1.000000,0.000000
1000121,qtsdk/qtsdk,3,1,4,0.750000,0.250000
1000003,qtsdk/qtsdk,249,57,306,0.813725,0.186275
1000004,qtsdk/qtsdk,12,9,21,0.571429,0.428571
1000054,qtsdk/qtsdk,11,9,20,0.550000,0.450000
1000391,qtsdk/qtsdk,4,2,6,0.666667,0.333333
1001288,qtsdk/qtsdk,0,2,2,0.000000,1.000000
1000009,qtsdk/qtsdk,2,0,2,1.000000,0.000000
1001419,qtsdk/qtsdk,6,4,10,0.600000,0.400000
1000012,qtsdk/qtsdk,4,6,10,0.400000,0.600000
1000013,qtsdk/qtsdk,2,0,2,1.000000,0.000000
1000014,qtsdk/qtsdk,3,1,4,0.750000,0.250000
1000015,qtsdk/qtsdk,4,1,5,0.800000,0.200000
1000145,qtsdk/qtsdk,4,6,10,0.400000,0.600000
1000023,qtsdk/qtsdk,237,117,354,0.669492,0.330508
1000153,qtsdk/qtsdk,3,5,8,0.375000,0.625000
1000026,qtsdk/qtsdk,2,0,2,1.000000,0.000000
1002588,qtsdk/qtsdk,2,0,2,1.000000,0.000000
1000032,qtsdk/qtsdk,2,3,5,0.400000,0.600000
1002807,qtsdk/qtsdk,2,0,2,1.000000,0.000000
1001186,qtsdk/qtsdk,1,2,3,0.333333,0.666667
1001572,qtsdk/qtsdk,4,4,8,0.500000,0.500000
1000166,qtsdk/qtsdk,4,6,10,0.400000,0.600000
1000017,qtsdk/qtsdk,24,9,33,0.727273,0.272727
1002472,qtsdk/qtsdk,12,5,17,0.705882,0.294118
1000681,qtsdk/qtsdk,7,0,7,1.000000,0.000000
1000298,qtsdk/qtsdk,2,3,5,0.400000,0.600000
1001454,qtsdk/qtsdk,153,69,222,0.689189,0.310811
1000061,qtsdk/qtsdk,2,2,4,0.500000,0.500000
1000049,qtsdk/qtsdk,1989,769,2758,0.721175,0.278825
1000822,qtsdk/qtsdk,1,2,3,0.333333,0.666667
1000566,qtsdk/qtsdk,28,3,31,0.903226,0.096774
1001982,qtsdk/qtsdk,68,20,88,0.772727,0.227273
1002402,qt-solutions/qt-solutions,1,0,1,1.000000,0.000000
1000004,qt-solutions/qt-solutions,5,0,5,1.000000,0.000000
1000391,qt-solutions/qt-solutions,3,4,7,0.428571,0.571429
1000014,qt-solutions/qt-solutions,13,2,15,0.866667,0.133333
1000015,qt-solutions/qt-solutions,2,0,2,1.000000,0.000000
1000592,qt-solutions/qt-solutions,1,4,5,0.200000,0.800000
1000049,qt-solutions/qt-solutions,60,37,97,0.618557,0.381443
1000338,qt-solutions/qt-solutions,5,3,8,0.625000,0.375000
1000023,qt-solutions/qt-solutions,8,0,8,1.000000,0.000000
1000120,qt-solutions/qt-solutions,1,2,3,0.333333,0.666667
1002272,test/project,2,0,2,1.000000,0.000000
1000049,test/project,4,14,18,0.222222,0.777778
1000121,test/project,1,1,2,0.500000,0.500000
1000049,www/doctools,72,17,89,0.808989,0.191011
1000298,www/doctools,8,0,8,1.000000,0.000000
1001419,www/doctools,2,0,2,1.000000,0.000000
1001572,www/doctools,2,0,2,1.000000,0.000000
1000049,www/downloads,19,2,21,0.904762,0.095238
1001984,www/planetqt,2,0,2,1.000000,0.000000
1002180,www/planetqt,1,0,1,1.000000,0.000000
1000006,www/planetqt,2,4,6,0.333333,0.666667
1000049,www/planetqt,88,34,122,0.721311,0.278689
1000146,www/planetqt,3,1,4,0.750000,0.250000
1002644,www/planetqt,3,6,9,0.333333,0.666667
1000312,www/planetqt,4,1,5,0.800000,0.200000
1000004,www/planetqt,2,0,2,1.000000,0.000000
