id,NumOfCur,NumOfIncur,PerOfCur,PerOfIncur,NumOfVotes
8202,3,12,0.200000,0.800000,15
8205,45,19,0.703125,0.296875,64
15,5,1,0.833333,0.166667,6
8208,1,0,1.000000,0.000000,1
8211,6,2,0.750000,0.250000,8
8212,6,10,0.375000,0.625000,16
8213,1,14,0.066667,0.933333,15
25,6,0,1.000000,0.000000,6
34,28,17,0.622222,0.377778,45
8229,3,22,0.120000,0.880000,25
8238,0,1,0.000000,1.000000,1
8240,10,3,0.769231,0.230769,13
53,3,10,0.230769,0.769231,13
8246,11,13,0.458333,0.541667,24
8255,3,4,0.428571,0.571429,7
8257,32,14,0.695652,0.304348,46
70,8,1,0.888889,0.111111,9
8264,1,39,0.025000,0.975000,40
73,2,6,0.250000,0.750000,8
8276,16,40,0.285714,0.714286,56
8277,0,1,0.000000,1.000000,1
88,2,2,0.500000,0.500000,4
8286,30,77,0.280374,0.719626,107
8291,1,22,0.043478,0.956522,23
8293,8,2,0.800000,0.200000,10
8296,1,12,0.076923,0.923077,13
8300,1,0,1.000000,0.000000,1
8303,1,1,0.500000,0.500000,2
113,1,0,1.000000,0.000000,1
8306,4,11,0.266667,0.733333,15
8309,1,0,1.000000,0.000000,1
8311,23,8,0.741935,0.258065,31
8312,4,5,0.444444,0.555556,9
124,6,2,0.750000,0.250000,8
126,2,0,1.000000,0.000000,2
128,5,5,0.500000,0.500000,10
8321,1,0,1.000000,0.000000,1
8322,1,1,0.500000,0.500000,2
8325,0,3,0.000000,1.000000,3
136,9,2,0.818182,0.181818,11
141,17,18,0.485714,0.514286,35
143,19,11,0.633333,0.366667,30
8338,4,0,1.000000,0.000000,4
8339,1,0,1.000000,0.000000,1
9582,20,18,0.526316,0.473684,38
8217,1,0,1.000000,0.000000,1
8344,5,1,0.833333,0.166667,6
154,13,10,0.565217,0.434783,23
156,8,1,0.888889,0.111111,9
161,20,32,0.384615,0.615385,52
8357,1,1,0.500000,0.500000,2
167,70,30,0.700000,0.300000,100
8367,23,42,0.353846,0.646154,65
180,1,3,0.250000,0.750000,4
8373,5,12,0.294118,0.705882,17
8378,1,0,1.000000,0.000000,1
8380,6,1,0.857143,0.142857,7
8386,3,1,0.750000,0.250000,4
8403,1,0,1.000000,0.000000,1
217,10,6,0.625000,0.375000,16
221,1,0,1.000000,0.000000,1
8414,36,14,0.720000,0.280000,50
8434,11,9,0.550000,0.450000,20
8435,2,2,0.500000,0.500000,4
8439,5,8,0.384615,0.615385,13
8446,0,3,0.000000,1.000000,3
8464,1,0,1.000000,0.000000,1
8468,8,10,0.444444,0.555556,18
8469,1,0,1.000000,0.000000,1
8470,6,5,0.545455,0.454545,11
8473,4,0,1.000000,0.000000,4
8478,1,17,0.055556,0.944444,18
287,30,14,0.681818,0.318182,44
290,1,5,0.166667,0.833333,6
8489,4,4,0.500000,0.500000,8
8493,1,0,1.000000,0.000000,1
8494,2,5,0.285714,0.714286,7
8495,4,6,0.400000,0.600000,10
8497,6,28,0.176471,0.823529,34
8499,1,10,0.090909,0.909091,11
8505,5,1,0.833333,0.166667,6
8510,18,16,0.529412,0.470588,34
8512,4,1,0.800000,0.200000,5
8513,17,12,0.586207,0.413793,29
8514,13,83,0.135417,0.864583,96
8247,46,47,0.494624,0.505376,93
335,49,52,0.485149,0.514851,101
8533,15,17,0.468750,0.531250,32
10377,4,0,1.000000,0.000000,4
8537,1,4,0.200000,0.800000,5
351,2,8,0.200000,0.800000,10
8545,7,2,0.777778,0.222222,9
356,7,8,0.466667,0.533333,15
8557,1,3,0.250000,0.750000,4
8564,1,1,0.500000,0.500000,2
8575,1,0,1.000000,0.000000,1
8576,50,19,0.724638,0.275362,69
8578,1,19,0.050000,0.950000,20
8582,1,1,0.500000,0.500000,2
8586,1,2,0.333333,0.666667,3
395,38,15,0.716981,0.283019,53
396,8,5,0.615385,0.384615,13
8596,1,0,1.000000,0.000000,1
8601,74,20,0.787234,0.212766,94
8603,15,4,0.789474,0.210526,19
8607,9,6,0.600000,0.400000,15
8262,1,0,1.000000,0.000000,1
427,0,1,0.000000,1.000000,1
428,10,24,0.294118,0.705882,34
8622,13,31,0.295455,0.704545,44
8623,13,41,0.240741,0.759259,54
8627,1,0,1.000000,0.000000,1
438,2,1,0.666667,0.333333,3
8632,1,0,1.000000,0.000000,1
449,6,2,0.750000,0.250000,8
8642,37,32,0.536232,0.463768,69
452,22,8,0.733333,0.266667,30
8646,53,46,0.535354,0.464646,99
8651,39,54,0.419355,0.580645,93
8660,3,2,0.600000,0.400000,5
8669,6,7,0.461538,0.538462,13
8670,2,3,0.400000,0.600000,5
8674,18,51,0.260870,0.739130,69
8687,8,4,0.666667,0.333333,12
8689,6,9,0.400000,0.600000,15
8690,32,12,0.727273,0.272727,44
8700,0,1,0.000000,1.000000,1
512,4,0,1.000000,0.000000,4
8718,1,5,0.166667,0.833333,6
532,10,13,0.434783,0.565217,23
8725,1,18,0.052632,0.947368,19
8726,1,6,0.142857,0.857143,7
537,1,0,1.000000,0.000000,1
8732,33,5,0.868421,0.131579,38
8736,62,49,0.558559,0.441441,111
9648,11,8,0.578947,0.421053,19
8740,1,2,0.333333,0.666667,3
8743,41,1,0.976190,0.023810,42
8745,12,1,0.923077,0.076923,13
8746,17,31,0.354167,0.645833,48
557,1,0,1.000000,0.000000,1
8754,18,20,0.473684,0.526316,38
564,1,0,1.000000,0.000000,1
8758,1,0,1.000000,0.000000,1
8767,54,29,0.650602,0.349398,83
8768,13,25,0.342105,0.657895,38
8770,3,1,0.750000,0.250000,4
8771,7,13,0.350000,0.650000,20
8775,1,6,0.142857,0.857143,7
8776,50,26,0.657895,0.342105,76
8777,86,28,0.754386,0.245614,114
8779,2,1,0.666667,0.333333,3
8782,13,2,0.866667,0.133333,15
8784,36,4,0.900000,0.100000,40
8792,2,6,0.250000,0.750000,8
8794,9,2,0.818182,0.181818,11
8802,40,11,0.784314,0.215686,51
9660,31,7,0.815789,0.184211,38
8810,7,23,0.233333,0.766667,30
631,4,9,0.307692,0.692308,13
8826,2,2,0.500000,0.500000,4
8829,49,28,0.636364,0.363636,77
8831,8,7,0.533333,0.466667,15
8832,6,1,0.857143,0.142857,7
8833,1,1,0.500000,0.500000,2
8844,49,7,0.875000,0.125000,56
8845,1,0,1.000000,0.000000,1
8856,1,0,1.000000,0.000000,1
8857,6,1,0.857143,0.142857,7
8859,11,28,0.282051,0.717949,39
8861,33,12,0.733333,0.266667,45
8863,77,12,0.865169,0.134831,89
8864,0,1,0.000000,1.000000,1
8866,15,23,0.394737,0.605263,38
8872,1,7,0.125000,0.875000,8
681,9,36,0.200000,0.800000,45
8876,3,6,0.333333,0.666667,9
114,1,2,0.333333,0.666667,3
8881,2,0,1.000000,0.000000,2
8888,4,43,0.085106,0.914894,47
8889,15,74,0.168539,0.831461,89
8890,34,74,0.314815,0.685185,108
8893,1,3,0.250000,0.750000,4
8895,56,34,0.622222,0.377778,90
8910,2,5,0.285714,0.714286,7
8911,38,12,0.760000,0.240000,50
8912,1,0,1.000000,0.000000,1
8922,2,0,1.000000,0.000000,2
8925,0,1,0.000000,1.000000,1
736,4,4,0.500000,0.500000,8
8930,74,42,0.637931,0.362069,116
740,2,0,1.000000,0.000000,2
745,6,2,0.750000,0.250000,8
8939,1,0,1.000000,0.000000,1
752,28,60,0.318182,0.681818,88
8318,32,9,0.780488,0.219512,41
8952,7,4,0.636364,0.363636,11
8954,14,4,0.777778,0.222222,18
8959,0,1,0.000000,1.000000,1
8962,1,0,1.000000,0.000000,1
8964,1,11,0.083333,0.916667,12
8970,10,1,0.909091,0.090909,11
8979,2,8,0.200000,0.800000,10
8984,18,21,0.461538,0.538462,39
794,5,8,0.384615,0.615385,13
8992,1,0,1.000000,0.000000,1
8994,2,3,0.400000,0.600000,5
8996,32,71,0.310680,0.689320,103
8997,2,1,0.666667,0.333333,3
9000,1,1,0.500000,0.500000,2
8328,18,7,0.720000,0.280000,25
9013,1,0,1.000000,0.000000,1
829,4,3,0.571429,0.428571,7
9024,0,15,0.000000,1.000000,15
838,67,21,0.761364,0.238636,88
842,15,2,0.882353,0.117647,17
845,2,1,0.666667,0.333333,3
9044,10,10,0.500000,0.500000,20
9045,0,3,0.000000,1.000000,3
10667,1,1,0.500000,0.500000,2
864,2,2,0.500000,0.500000,4
144,18,7,0.720000,0.280000,25
9059,5,26,0.161290,0.838710,31
9060,1,0,1.000000,0.000000,1
9062,11,48,0.186441,0.813559,59
9063,1,1,0.500000,0.500000,2
9064,41,13,0.759259,0.240741,54
9067,1,10,0.090909,0.909091,11
9068,4,2,0.666667,0.333333,6
9073,13,8,0.619048,0.380952,21
882,7,14,0.333333,0.666667,21
9076,7,1,0.875000,0.125000,8
9077,1,0,1.000000,0.000000,1
9083,1,0,1.000000,0.000000,1
894,23,26,0.469388,0.530612,49
9089,2,4,0.333333,0.666667,6
901,3,3,0.500000,0.500000,6
904,25,12,0.675676,0.324324,37
905,9,6,0.600000,0.400000,15
9098,48,26,0.648649,0.351351,74
9100,11,53,0.171875,0.828125,64
9101,48,30,0.615385,0.384615,78
9111,16,1,0.941176,0.058824,17
927,13,17,0.433333,0.566667,30
9122,1,0,1.000000,0.000000,1
931,1,1,0.500000,0.500000,2
9126,18,16,0.529412,0.470588,34
935,11,8,0.578947,0.421053,19
936,4,1,0.800000,0.200000,5
9129,2,1,0.666667,0.333333,3
941,3,4,0.428571,0.571429,7
9139,4,3,0.571429,0.428571,7
951,27,8,0.771429,0.228571,35
9145,0,1,0.000000,1.000000,1
9146,1,0,1.000000,0.000000,1
9717,64,49,0.566372,0.433628,113
961,4,1,0.800000,0.200000,5
9166,1,0,1.000000,0.000000,1
979,62,52,0.543860,0.456140,114
9173,9,34,0.209302,0.790698,43
9180,20,8,0.714286,0.285714,28
998,9,10,0.473684,0.526316,19
9191,14,3,0.823529,0.176471,17
9192,1,1,0.500000,0.500000,2
1004,80,35,0.695652,0.304348,115
1007,52,52,0.500000,0.500000,104
9200,16,2,0.888889,0.111111,18
1009,29,11,0.725000,0.275000,40
1011,9,9,0.500000,0.500000,18
9204,1,7,0.125000,0.875000,8
9726,0,2,0.000000,1.000000,2
9208,0,1,0.000000,1.000000,1
9209,11,5,0.687500,0.312500,16
9214,28,51,0.354430,0.645570,79
1026,2,1,0.666667,0.333333,3
9223,10,15,0.400000,0.600000,25
9225,41,50,0.450549,0.549451,91
9227,18,1,0.947368,0.052632,19
1037,1,0,1.000000,0.000000,1
1038,26,12,0.684211,0.315789,38
9234,27,12,0.692308,0.307692,39
9236,10,8,0.555556,0.444444,18
1049,20,11,0.645161,0.354839,31
1053,2,8,0.200000,0.800000,10
1054,72,41,0.637168,0.362832,113
9248,1,17,0.055556,0.944444,18
9249,10,1,0.909091,0.090909,11
9253,1,2,0.333333,0.666667,3
1063,50,29,0.632911,0.367089,79
9257,10,1,0.909091,0.090909,11
9259,2,1,0.666667,0.333333,3
1073,12,6,0.666667,0.333333,18
9268,34,28,0.548387,0.451613,62
9272,3,1,0.750000,0.250000,4
1082,67,18,0.788235,0.211765,85
9276,6,1,0.857143,0.142857,7
9277,5,11,0.312500,0.687500,16
9278,2,4,0.333333,0.666667,6
1091,45,15,0.750000,0.250000,60
9295,1,12,0.076923,0.923077,13
9300,0,6,0.000000,1.000000,6
9303,1,0,1.000000,0.000000,1
1112,8,0,1.000000,0.000000,8
9311,6,18,0.250000,0.750000,24
9318,17,1,0.944444,0.055556,18
1127,1,8,0.111111,0.888889,9
9320,8,17,0.320000,0.680000,25
9332,1,0,1.000000,0.000000,1
9335,9,33,0.214286,0.785714,42
9339,1,2,0.333333,0.666667,3
1155,86,30,0.741379,0.258621,116
9349,1,4,0.200000,0.800000,5
9350,5,0,1.000000,0.000000,5
9352,4,1,0.800000,0.200000,5
9355,1,1,0.500000,0.500000,2
9356,1,2,0.333333,0.666667,3
9359,0,16,0.000000,1.000000,16
9363,2,17,0.105263,0.894737,19
9364,70,15,0.823529,0.176471,85
9366,31,43,0.418919,0.581081,74
1175,5,2,0.714286,0.285714,7
1176,1,5,0.166667,0.833333,6
1177,33,27,0.550000,0.450000,60
9375,1,1,0.500000,0.500000,2
1184,3,1,0.750000,0.250000,4
9377,1,2,0.333333,0.666667,3
1188,11,1,0.916667,0.083333,12
9383,20,6,0.769231,0.230769,26
9386,4,2,0.666667,0.333333,6
9387,68,33,0.673267,0.326733,101
9392,2,0,1.000000,0.000000,2
9396,4,1,0.800000,0.200000,5
9407,3,2,0.600000,0.400000,5
9409,9,25,0.264706,0.735294,34
9410,9,10,0.473684,0.526316,19
9411,1,1,0.500000,0.500000,2
9412,25,91,0.215517,0.784483,116
9415,8,6,0.571429,0.428571,14
9416,0,10,0.000000,1.000000,10
9426,1,3,0.250000,0.750000,4
9429,1,1,0.500000,0.500000,2
9431,26,9,0.742857,0.257143,35
1253,13,6,0.684211,0.315789,19
8401,2,11,0.153846,0.846154,13
9448,1,0,1.000000,0.000000,1
9449,28,68,0.291667,0.708333,96
9454,17,6,0.739130,0.260870,23
9455,1,12,0.076923,0.923077,13
1269,10,14,0.416667,0.583333,24
1271,2,4,0.333333,0.666667,6
9466,1,2,0.333333,0.666667,3
9473,5,2,0.714286,0.285714,7
9475,1,0,1.000000,0.000000,1
9480,2,0,1.000000,0.000000,2
9483,6,10,0.375000,0.625000,16
9485,11,9,0.550000,0.450000,20
9488,58,34,0.630435,0.369565,92
9493,2,1,0.666667,0.333333,3
9497,1,2,0.333333,0.666667,3
9499,27,19,0.586957,0.413043,46
9500,21,5,0.807692,0.192308,26
1322,9,8,0.529412,0.470588,17
9778,13,1,0.928571,0.071429,14
1326,0,2,0.000000,1.000000,2
9520,62,17,0.784810,0.215190,79
9521,1,1,0.500000,0.500000,2
1330,2,6,0.250000,0.750000,8
1333,1,5,0.166667,0.833333,6
9528,2,4,0.333333,0.666667,6
9531,1,0,1.000000,0.000000,1
9536,4,8,0.333333,0.666667,12
9545,50,30,0.625000,0.375000,80
9546,2,1,0.666667,0.333333,3
9550,4,10,0.285714,0.714286,14
9552,44,29,0.602740,0.397260,73
9554,3,14,0.176471,0.823529,17
9556,1,0,1.000000,0.000000,1
9560,55,40,0.578947,0.421053,95
9561,1,1,0.500000,0.500000,2
9563,14,13,0.518519,0.481481,27
9565,1,2,0.333333,0.666667,3
9569,35,82,0.299145,0.700855,117
9571,4,5,0.444444,0.555556,9
9577,3,5,0.375000,0.625000,8
9581,2,2,0.500000,0.500000,4
9583,1,12,0.076923,0.923077,13
1394,5,6,0.454545,0.545455,11
1395,3,0,1.000000,0.000000,3
1397,5,4,0.555556,0.444444,9
9596,1,1,0.500000,0.500000,2
9598,1,2,0.333333,0.666667,3
9599,2,15,0.117647,0.882353,17
9601,1,8,0.111111,0.888889,9
9605,0,4,0.000000,1.000000,4
9608,13,4,0.764706,0.235294,17
1419,49,18,0.731343,0.268657,67
1422,2,6,0.250000,0.750000,8
9617,0,2,0.000000,1.000000,2
9623,3,1,0.750000,0.250000,4
9624,36,68,0.346154,0.653846,104
9625,2,3,0.400000,0.600000,5
9626,3,2,0.600000,0.400000,5
1441,28,8,0.777778,0.222222,36
1446,8,14,0.363636,0.636364,22
9642,1,0,1.000000,0.000000,1
1452,4,3,0.571429,0.428571,7
9645,28,65,0.301075,0.698925,93
9647,20,30,0.400000,0.600000,50
1456,67,30,0.690722,0.309278,97
11166,7,6,0.538462,0.461538,13
9658,1,0,1.000000,0.000000,1
9659,29,24,0.547170,0.452830,53
1468,2,0,1.000000,0.000000,2
9664,17,13,0.566667,0.433333,30
9665,3,5,0.375000,0.625000,8
9669,8,6,0.571429,0.428571,14
9680,2,16,0.111111,0.888889,18
9683,34,25,0.576271,0.423729,59
9684,47,45,0.510870,0.489130,92
9686,2,6,0.250000,0.750000,8
9691,0,4,0.000000,1.000000,4
9692,31,56,0.356322,0.643678,87
9698,6,8,0.428571,0.571429,14
9700,6,8,0.428571,0.571429,14
9702,2,0,1.000000,0.000000,2
9705,4,1,0.800000,0.200000,5
9706,0,8,0.000000,1.000000,8
9708,51,51,0.500000,0.500000,102
1523,0,2,0.000000,1.000000,2
9719,26,2,0.928571,0.071429,28
9722,1,1,0.500000,0.500000,2
1534,5,1,0.833333,0.166667,6
9729,0,7,0.000000,1.000000,7
9730,5,4,0.555556,0.444444,9
9731,3,23,0.115385,0.884615,26
1549,20,11,0.645161,0.354839,31
9746,19,4,0.826087,0.173913,23
1555,2,0,1.000000,0.000000,2
9749,5,7,0.416667,0.583333,12
9751,6,34,0.150000,0.850000,40
9752,0,1,0.000000,1.000000,1
9755,2,7,0.222222,0.777778,9
9765,8,3,0.727273,0.272727,11
9768,19,2,0.904762,0.095238,21
9770,1,1,0.500000,0.500000,2
9777,1,1,0.500000,0.500000,2
1586,1,0,1.000000,0.000000,1
9782,7,2,0.777778,0.222222,9
9788,2,25,0.074074,0.925926,27
1603,65,30,0.684211,0.315789,95
1605,34,26,0.566667,0.433333,60
1607,50,59,0.458716,0.541284,109
1616,16,3,0.842105,0.157895,19
9810,1,1,0.500000,0.500000,2
9811,6,6,0.500000,0.500000,12
9828,12,22,0.352941,0.647059,34
1627,46,44,0.511111,0.488889,90
9820,7,8,0.466667,0.533333,15
1633,3,9,0.250000,0.750000,12
1636,11,13,0.458333,0.541667,24
9835,7,1,0.875000,0.125000,8
9836,1,12,0.076923,0.923077,13
9839,2,0,1.000000,0.000000,2
9846,36,57,0.387097,0.612903,93
9847,25,17,0.595238,0.404762,42
1657,9,6,0.600000,0.400000,15
1660,2,0,1.000000,0.000000,2
9853,2,2,0.500000,0.500000,4
9865,1,2,0.333333,0.666667,3
9869,1,0,1.000000,0.000000,1
1678,52,24,0.684211,0.315789,76
1687,0,1,0.000000,1.000000,1
1690,7,1,0.875000,0.125000,8
9885,2,3,0.400000,0.600000,5
1699,30,38,0.441176,0.558824,68
9894,4,2,0.666667,0.333333,6
9895,3,8,0.272727,0.727273,11
9897,5,35,0.125000,0.875000,40
1706,24,21,0.533333,0.466667,45
1710,1,0,1.000000,0.000000,1
9906,15,2,0.882353,0.117647,17
9907,1,3,0.250000,0.750000,4
9910,14,7,0.666667,0.333333,21
9911,5,10,0.333333,0.666667,15
9914,11,1,0.916667,0.083333,12
8479,0,5,0.000000,1.000000,5
9921,2,2,0.500000,0.500000,4
9922,1,0,1.000000,0.000000,1
1731,27,3,0.900000,0.100000,30
9927,3,0,1.000000,0.000000,3
9932,1,5,0.166667,0.833333,6
9940,2,2,0.500000,0.500000,4
1749,1,1,0.500000,0.500000,2
9943,1,1,0.500000,0.500000,2
9946,1,0,1.000000,0.000000,1
9954,24,20,0.545455,0.454545,44
9958,3,2,0.600000,0.400000,5
9852,3,4,0.428571,0.571429,7
9970,7,24,0.225806,0.774194,31
1782,31,18,0.632653,0.367347,49
1783,1,2,0.333333,0.666667,3
9976,9,5,0.642857,0.357143,14
9977,41,9,0.820000,0.180000,50
9978,45,44,0.505618,0.494382,89
9981,35,40,0.466667,0.533333,75
9983,8,13,0.380952,0.619048,21
1792,2,0,1.000000,0.000000,2
1794,29,20,0.591837,0.408163,49
9991,7,1,0.875000,0.125000,8
1803,31,21,0.596154,0.403846,52
1805,1,2,0.333333,0.666667,3
10003,0,2,0.000000,1.000000,2
1814,2,0,1.000000,0.000000,2
10007,18,24,0.428571,0.571429,42
10010,1,1,0.500000,0.500000,2
10014,37,18,0.672727,0.327273,55
10016,1,4,0.200000,0.800000,5
1826,1,11,0.083333,0.916667,12
10972,1,0,1.000000,0.000000,1
1836,3,1,0.750000,0.250000,4
1839,7,15,0.318182,0.681818,22
1850,7,7,0.500000,0.500000,14
10045,0,2,0.000000,1.000000,2
10046,1,8,0.111111,0.888889,9
10048,1,2,0.333333,0.666667,3
1865,77,42,0.647059,0.352941,119
10058,1,11,0.083333,0.916667,12
1870,2,7,0.222222,0.777778,9
10063,24,13,0.648649,0.351351,37
1872,10,10,0.500000,0.500000,20
10065,2,0,1.000000,0.000000,2
1882,26,36,0.419355,0.580645,62
1894,2,11,0.153846,0.846154,13
10094,18,25,0.418605,0.581395,43
1904,20,5,0.800000,0.200000,25
10099,22,26,0.458333,0.541667,48
10104,1,0,1.000000,0.000000,1
1914,1,0,1.000000,0.000000,1
10112,58,52,0.527273,0.472727,110
1923,6,13,0.315789,0.684211,19
10121,13,43,0.232143,0.767857,56
10126,37,30,0.552239,0.447761,67
1935,37,17,0.685185,0.314815,54
1943,1,0,1.000000,0.000000,1
10136,11,5,0.687500,0.312500,16
10139,4,1,0.800000,0.200000,5
1952,3,1,0.750000,0.250000,4
10145,30,16,0.652174,0.347826,46
1958,2,0,1.000000,0.000000,2
10161,4,8,0.333333,0.666667,12
10163,1,2,0.333333,0.666667,3
10165,34,27,0.557377,0.442623,61
1981,47,6,0.886792,0.113208,53
10177,7,4,0.636364,0.363636,11
10179,24,39,0.380952,0.619048,63
1991,14,15,0.482759,0.517241,29
10184,7,24,0.225806,0.774194,31
1998,30,9,0.769231,0.230769,39
10192,2,5,0.285714,0.714286,7
10197,4,2,0.666667,0.333333,6
9614,1,6,0.142857,0.857143,7
10200,11,15,0.423077,0.576923,26
2011,15,18,0.454545,0.545455,33
10206,5,7,0.416667,0.583333,12
10208,6,1,0.857143,0.142857,7
10210,1,7,0.125000,0.875000,8
10212,16,45,0.262295,0.737705,61
10215,14,9,0.608696,0.391304,23
10217,13,3,0.812500,0.187500,16
10218,7,1,0.875000,0.125000,8
10222,1,0,1.000000,0.000000,1
10224,1,0,1.000000,0.000000,1
2033,42,7,0.857143,0.142857,49
2036,6,1,0.857143,0.142857,7
10234,2,0,1.000000,0.000000,2
2043,22,7,0.758621,0.241379,29
10237,1,0,1.000000,0.000000,1
10242,22,20,0.523810,0.476190,42
10243,3,14,0.176471,0.823529,17
10247,20,12,0.625000,0.375000,32
10250,6,8,0.428571,0.571429,14
10253,11,2,0.846154,0.153846,13
2062,12,10,0.545455,0.454545,22
2064,66,27,0.709677,0.290323,93
10257,5,11,0.312500,0.687500,16
10258,0,5,0.000000,1.000000,5
2067,1,2,0.333333,0.666667,3
2069,13,41,0.240741,0.759259,54
10266,1,0,1.000000,0.000000,1
10269,15,20,0.428571,0.571429,35
10272,5,23,0.178571,0.821429,28
10273,1,0,1.000000,0.000000,1
10275,6,17,0.260870,0.739130,23
10277,19,3,0.863636,0.136364,22
10280,2,0,1.000000,0.000000,2
10281,1,3,0.250000,0.750000,4
10284,2,0,1.000000,0.000000,2
2095,0,1,0.000000,1.000000,1
2096,6,6,0.500000,0.500000,12
10290,7,12,0.368421,0.631579,19
10291,1,13,0.071429,0.928571,14
2101,2,15,0.117647,0.882353,17
10295,82,32,0.719298,0.280702,114
10297,1,7,0.125000,0.875000,8
2106,6,7,0.461538,0.538462,13
8543,6,1,0.857143,0.142857,7
2109,9,15,0.375000,0.625000,24
2115,2,7,0.222222,0.777778,9
10318,1,8,0.111111,0.888889,9
10321,4,5,0.444444,0.555556,9
10322,2,4,0.333333,0.666667,6
10327,18,1,0.947368,0.052632,19
2140,30,24,0.555556,0.444444,54
2147,1,0,1.000000,0.000000,1
10355,1,5,0.166667,0.833333,6
10356,1,3,0.250000,0.750000,4
2170,31,47,0.397436,0.602564,78
9347,21,24,0.466667,0.533333,45
10373,28,38,0.424242,0.575758,66
10374,13,35,0.270833,0.729167,48
10375,2,0,1.000000,0.000000,2
2185,7,1,0.875000,0.125000,8
10378,26,49,0.346667,0.653333,75
10379,10,21,0.322581,0.677419,31
10384,3,5,0.375000,0.625000,8
10387,20,10,0.666667,0.333333,30
10391,50,66,0.431034,0.568966,116
10392,2,5,0.285714,0.714286,7
2201,13,1,0.928571,0.071429,14
10405,0,1,0.000000,1.000000,1
10414,0,1,0.000000,1.000000,1
2226,10,11,0.476190,0.523810,21
10419,0,2,0.000000,1.000000,2
10420,5,1,0.833333,0.166667,6
2230,43,15,0.741379,0.258621,58
10427,0,1,0.000000,1.000000,1
2238,6,15,0.285714,0.714286,21
2245,9,7,0.562500,0.437500,16
10444,0,1,0.000000,1.000000,1
2256,0,3,0.000000,1.000000,3
2261,1,7,0.125000,0.875000,8
2264,1,0,1.000000,0.000000,1
10459,4,3,0.571429,0.428571,7
10466,0,4,0.000000,1.000000,4
10469,1,5,0.166667,0.833333,6
2282,0,3,0.000000,1.000000,3
10475,34,27,0.557377,0.442623,61
10477,1,0,1.000000,0.000000,1
10479,5,10,0.333333,0.666667,15
10480,2,2,0.500000,0.500000,4
10486,8,23,0.258065,0.741935,31
10489,2,22,0.083333,0.916667,24
10492,2,4,0.333333,0.666667,6
10495,1,1,0.500000,0.500000,2
8577,1,2,0.333333,0.666667,3
10504,2,2,0.500000,0.500000,4
2313,0,1,0.000000,1.000000,1
2315,2,2,0.500000,0.500000,4
10509,1,0,1.000000,0.000000,1
10511,1,1,0.500000,0.500000,2
10513,1,5,0.166667,0.833333,6
2322,1,1,0.500000,0.500000,2
2323,2,1,0.666667,0.333333,3
2325,75,31,0.707547,0.292453,106
10519,9,11,0.450000,0.550000,20
10521,8,16,0.333333,0.666667,24
10523,11,0,1.000000,0.000000,11
10527,17,9,0.653846,0.346154,26
10536,0,3,0.000000,1.000000,3
10540,0,4,0.000000,1.000000,4
2349,4,1,0.800000,0.200000,5
10550,1,0,1.000000,0.000000,1
11316,2,0,1.000000,0.000000,2
10556,10,6,0.625000,0.375000,16
8587,30,14,0.681818,0.318182,44
10569,1,6,0.142857,0.857143,7
10571,2,0,1.000000,0.000000,2
2383,3,1,0.750000,0.250000,4
2384,1,1,0.500000,0.500000,2
10578,3,2,0.600000,0.400000,5
10579,1,0,1.000000,0.000000,1
2388,6,8,0.428571,0.571429,14
2394,7,5,0.583333,0.416667,12
10589,1,3,0.250000,0.750000,4
2400,2,5,0.285714,0.714286,7
2401,19,52,0.267606,0.732394,71
10594,1,2,0.333333,0.666667,3
11323,1,1,0.500000,0.500000,2
2405,1,4,0.200000,0.800000,5
10607,33,22,0.600000,0.400000,55
10608,6,4,0.600000,0.400000,10
2419,2,2,0.500000,0.500000,4
10612,4,24,0.142857,0.857143,28
2421,4,5,0.444444,0.555556,9
9961,5,4,0.555556,0.444444,9
10618,1,1,0.500000,0.500000,2
10624,2,0,1.000000,0.000000,2
10626,55,29,0.654762,0.345238,84
10631,0,4,0.000000,1.000000,4
10644,5,1,0.833333,0.166667,6
10646,17,7,0.708333,0.291667,24
10652,1,4,0.200000,0.800000,5
2463,43,3,0.934783,0.065217,46
10656,8,1,0.888889,0.111111,9
2466,0,1,0.000000,1.000000,1
10665,14,3,0.823529,0.176471,17
10669,1,0,1.000000,0.000000,1
2481,38,23,0.622951,0.377049,61
9971,1,2,0.333333,0.666667,3
10676,16,8,0.666667,0.333333,24
2486,0,1,0.000000,1.000000,1
2487,14,12,0.538462,0.461538,26
10683,1,0,1.000000,0.000000,1
10692,19,0,1.000000,0.000000,19
2505,1,3,0.250000,0.750000,4
2510,5,3,0.625000,0.375000,8
10705,15,3,0.833333,0.166667,18
2515,1,2,0.333333,0.666667,3
10712,0,7,0.000000,1.000000,7
10725,8,7,0.533333,0.466667,15
2535,17,7,0.708333,0.291667,24
10728,1,0,1.000000,0.000000,1
10731,14,4,0.777778,0.222222,18
8617,19,6,0.760000,0.240000,25
2556,4,18,0.181818,0.818182,22
10750,0,1,0.000000,1.000000,1
2559,21,22,0.488372,0.511628,43
10765,6,15,0.285714,0.714286,21
10768,5,2,0.714286,0.285714,7
9987,1,0,1.000000,0.000000,1
2583,32,55,0.367816,0.632184,87
2585,2,3,0.400000,0.600000,5
10787,8,1,0.888889,0.111111,9
10796,2,1,0.666667,0.333333,3
10806,1,1,0.500000,0.500000,2
10807,1,1,0.500000,0.500000,2
10818,3,2,0.600000,0.400000,5
10822,1,0,1.000000,0.000000,1
2634,4,6,0.400000,0.600000,10
10829,8,4,0.666667,0.333333,12
9997,2,0,1.000000,0.000000,2
10836,2,1,0.666667,0.333333,3
2649,23,65,0.261364,0.738636,88
2652,3,1,0.750000,0.250000,4
2654,23,12,0.657143,0.342857,35
10847,13,10,0.565217,0.434783,23
2672,1,8,0.111111,0.888889,9
10873,8,7,0.533333,0.466667,15
10876,0,1,0.000000,1.000000,1
2697,32,33,0.492308,0.507692,65
10897,2,0,1.000000,0.000000,2
10899,2,3,0.400000,0.600000,5
10901,1,1,0.500000,0.500000,2
10907,1,6,0.142857,0.857143,7
10909,16,1,0.941176,0.058824,17
10911,1,1,0.500000,0.500000,2
10917,15,1,0.937500,0.062500,16
10922,1,1,0.500000,0.500000,2
8647,1,5,0.166667,0.833333,6
2741,1,0,1.000000,0.000000,1
10945,2,2,0.500000,0.500000,4
2754,2,3,0.400000,0.600000,5
10950,1,0,1.000000,0.000000,1
2763,2,2,0.500000,0.500000,4
10018,8,16,0.333333,0.666667,24
10959,36,48,0.428571,0.571429,84
9367,1,4,0.200000,0.800000,5
10973,6,1,0.857143,0.142857,7
2799,73,39,0.651786,0.348214,112
2807,15,19,0.441176,0.558824,34
11006,8,8,0.500000,0.500000,16
11011,40,49,0.449438,0.550562,89
2825,1,1,0.500000,0.500000,2
2828,49,22,0.690141,0.309859,71
11022,2,8,0.200000,0.800000,10
11024,8,9,0.470588,0.529412,17
11029,1,0,1.000000,0.000000,1
11036,0,4,0.000000,1.000000,4
11043,5,0,1.000000,0.000000,5
11047,3,1,0.750000,0.250000,4
11054,1,1,0.500000,0.500000,2
2872,1,0,1.000000,0.000000,1
11069,1,0,1.000000,0.000000,1
2883,2,1,0.666667,0.333333,3
11079,1,3,0.250000,0.750000,4
11082,14,8,0.636364,0.363636,22
11090,21,21,0.500000,0.500000,42
11105,2,3,0.400000,0.600000,5
2914,0,1,0.000000,1.000000,1
11109,9,4,0.692308,0.307692,13
11110,2,0,1.000000,0.000000,2
11113,3,10,0.230769,0.769231,13
2933,3,4,0.428571,0.571429,7
2934,14,8,0.636364,0.363636,22
2949,1,0,1.000000,0.000000,1
2961,38,20,0.655172,0.344828,58
2967,79,38,0.675214,0.324786,117
2974,3,3,0.500000,0.500000,6
11176,3,3,0.500000,0.500000,6
2998,1,4,0.200000,0.800000,5
11196,1,1,0.500000,0.500000,2
3009,77,41,0.652542,0.347458,118
3031,40,32,0.555556,0.444444,72
11234,10,12,0.454545,0.545455,22
3054,0,16,0.000000,1.000000,16
3076,1,2,0.333333,0.666667,3
3085,5,6,0.454545,0.545455,11
3098,46,38,0.547619,0.452381,84
10074,1,1,0.500000,0.500000,2
3108,32,16,0.666667,0.333333,48
11302,1,0,1.000000,0.000000,1
11305,2,0,1.000000,0.000000,2
3114,1,0,1.000000,0.000000,1
3124,1,6,0.142857,0.857143,7
3131,0,1,0.000000,1.000000,1
11343,1,0,1.000000,0.000000,1
11366,4,2,0.666667,0.333333,6
3189,24,27,0.470588,0.529412,51
3191,15,72,0.172414,0.827586,87
3208,2,0,1.000000,0.000000,2
10096,1,0,1.000000,0.000000,1
11020,28,25,0.528302,0.471698,53
10106,2,3,0.400000,0.600000,5
10110,4,13,0.235294,0.764706,17
10113,7,5,0.583333,0.416667,12
10127,40,38,0.512821,0.487179,78
579,0,1,0.000000,1.000000,1
595,45,25,0.642857,0.357143,70
8305,7,4,0.636364,0.363636,11
9397,12,13,0.480000,0.520000,25
10771,2,7,0.222222,0.777778,9
8873,30,12,0.714286,0.285714,42
4108,86,14,0.860000,0.140000,100
4116,3,2,0.600000,0.400000,5
4120,38,20,0.655172,0.344828,58
4128,6,7,0.461538,0.538462,13
4141,5,2,0.714286,0.285714,7
4149,30,12,0.714286,0.285714,42
4150,0,4,0.000000,1.000000,4
4159,29,22,0.568627,0.431373,51
4175,0,16,0.000000,1.000000,16
4181,1,0,1.000000,0.000000,1
4184,6,4,0.600000,0.400000,10
4187,2,5,0.285714,0.714286,7
4196,5,1,0.833333,0.166667,6
4200,2,15,0.117647,0.882353,17
4217,1,0,1.000000,0.000000,1
10261,12,3,0.800000,0.200000,15
4277,20,21,0.487805,0.512195,41
4295,1,0,1.000000,0.000000,1
4299,14,33,0.297872,0.702128,47
4302,27,8,0.771429,0.228571,35
4303,3,7,0.300000,0.700000,10
4325,38,10,0.791667,0.208333,48
4340,20,9,0.689655,0.310345,29
4362,2,2,0.500000,0.500000,4
4375,55,63,0.466102,0.533898,118
4381,46,70,0.396552,0.603448,116
4405,1,0,1.000000,0.000000,1
4411,13,3,0.812500,0.187500,16
10293,4,0,1.000000,0.000000,4
4418,26,4,0.866667,0.133333,30
4435,2,2,0.500000,0.500000,4
8932,7,32,0.179487,0.820513,39
8933,0,1,0.000000,1.000000,1
4455,3,1,0.750000,0.250000,4
4460,54,36,0.600000,0.400000,90
4473,23,13,0.638889,0.361111,36
8940,1,0,1.000000,0.000000,1
10307,9,1,0.900000,0.100000,10
4517,1,0,1.000000,0.000000,1
4531,1,1,0.500000,0.500000,2
4556,3,3,0.500000,0.500000,6
4567,4,2,0.666667,0.333333,6
4569,2,10,0.166667,0.833333,12
4592,2,11,0.153846,0.846154,13
4608,5,5,0.500000,0.500000,10
4610,4,12,0.250000,0.750000,16
4625,24,12,0.666667,0.333333,36
4630,1,9,0.100000,0.900000,10
4634,3,3,0.500000,0.500000,6
4642,2,1,0.666667,0.333333,3
4693,1,1,0.500000,0.500000,2
4720,4,25,0.137931,0.862069,29
4726,13,17,0.433333,0.566667,30
4727,14,33,0.297872,0.702128,47
10254,14,11,0.560000,0.440000,25
4919,30,39,0.434783,0.565217,69
4922,21,15,0.583333,0.416667,36
4938,1,3,0.250000,0.750000,4
4953,1,0,1.000000,0.000000,1
4954,40,22,0.645161,0.354839,62
4961,4,1,0.800000,0.200000,5
4983,2,0,1.000000,0.000000,2
4987,15,17,0.468750,0.531250,32
5021,1,6,0.142857,0.857143,7
5052,2,4,0.333333,0.666667,6
5055,5,3,0.625000,0.375000,8
6715,19,13,0.593750,0.406250,32
5063,9,0,1.000000,0.000000,9
5094,7,10,0.411765,0.588235,17
11081,5,0,1.000000,0.000000,5
5118,1,6,0.142857,0.857143,7
5149,13,1,0.928571,0.071429,14
5162,13,4,0.764706,0.235294,17
5170,94,22,0.810345,0.189655,116
5189,15,45,0.250000,0.750000,60
5200,2,3,0.400000,0.600000,5
5201,13,18,0.419355,0.580645,31
5202,4,8,0.333333,0.666667,12
5208,8,13,0.380952,0.619048,21
5209,11,13,0.458333,0.541667,24
5215,18,43,0.295082,0.704918,61
5217,13,12,0.520000,0.480000,25
5220,1,2,0.333333,0.666667,3
5222,4,3,0.571429,0.428571,7
5230,17,9,0.653846,0.346154,26
5240,1,0,1.000000,0.000000,1
5258,2,19,0.095238,0.904762,21
5259,1,0,1.000000,0.000000,1
10435,23,8,0.741935,0.258065,31
5300,5,6,0.454545,0.545455,11
5311,0,1,0.000000,1.000000,1
5314,22,17,0.564103,0.435897,39
5319,15,24,0.384615,0.615385,39
5343,1,1,0.500000,0.500000,2
5367,61,40,0.603960,0.396040,101
5387,13,29,0.309524,0.690476,42
9093,1,1,0.500000,0.500000,2
5410,1,1,0.500000,0.500000,2
9096,5,1,0.833333,0.166667,6
5456,1,0,1.000000,0.000000,1
10474,4,3,0.571429,0.428571,7
5520,3,0,1.000000,0.000000,3
5545,57,61,0.483051,0.516949,118
5557,5,1,0.833333,0.166667,6
5558,13,7,0.650000,0.350000,20
9119,1,0,1.000000,0.000000,1
5575,5,6,0.454545,0.545455,11
8369,8,4,0.666667,0.333333,12
9123,1,0,1.000000,0.000000,1
5600,5,7,0.416667,0.583333,12
9461,8,15,0.347826,0.652174,23
5619,10,15,0.400000,0.600000,25
5639,53,38,0.582418,0.417582,91
10503,0,2,0.000000,1.000000,2
5706,5,6,0.454545,0.545455,11
5727,13,20,0.393939,0.606061,33
5743,1,1,0.500000,0.500000,2
10515,2,0,1.000000,0.000000,2
10517,6,2,0.750000,0.250000,8
5057,1,3,0.250000,0.750000,4
5792,2,0,1.000000,0.000000,2
5851,0,2,0.000000,1.000000,2
9171,70,20,0.777778,0.222222,90
5890,1,0,1.000000,0.000000,1
5892,8,2,0.800000,0.200000,10
5902,1,0,1.000000,0.000000,1
5906,1,4,0.200000,0.800000,5
5909,85,21,0.801887,0.198113,106
5950,77,34,0.693694,0.306306,111
5955,5,6,0.454545,0.545455,11
5956,32,4,0.888889,0.111111,36
9186,2,2,0.500000,0.500000,4
5983,6,20,0.230769,0.769231,26
9190,14,20,0.411765,0.588235,34
5995,1,1,0.500000,0.500000,2
6039,45,39,0.535714,0.464286,84
6055,2,2,0.500000,0.500000,4
8931,17,18,0.485714,0.514286,35
6073,2,1,0.666667,0.333333,3
6076,2,3,0.400000,0.600000,5
9205,18,1,0.947368,0.052632,19
6088,3,1,0.750000,0.250000,4
10575,5,1,0.833333,0.166667,6
6116,47,21,0.691176,0.308824,68
6124,19,9,0.678571,0.321429,28
6139,3,2,0.600000,0.400000,5
6153,41,15,0.732143,0.267857,56
9218,5,16,0.238095,0.761905,21
6160,4,2,0.666667,0.333333,6
9753,0,1,0.000000,1.000000,1
6223,37,4,0.902439,0.097561,41
6230,29,21,0.580000,0.420000,50
6237,1,1,0.500000,0.500000,2
10028,1,2,0.333333,0.666667,3
10301,7,5,0.583333,0.416667,12
6274,12,13,0.480000,0.520000,25
6282,12,8,0.600000,0.400000,20
6287,34,32,0.515152,0.484848,66
6288,1,1,0.500000,0.500000,2
9246,3,1,0.750000,0.250000,4
6390,0,1,0.000000,1.000000,1
6414,8,5,0.615385,0.384615,13
6419,1,0,1.000000,0.000000,1
6434,2,13,0.133333,0.866667,15
6437,1,1,0.500000,0.500000,2
6447,24,55,0.303797,0.696203,79
6461,40,19,0.677966,0.322034,59
6462,8,1,0.888889,0.111111,9
6463,7,7,0.500000,0.500000,14
6469,3,3,0.500000,0.500000,6
6470,7,21,0.250000,0.750000,28
6472,5,8,0.384615,0.615385,13
6473,40,35,0.533333,0.466667,75
6483,14,5,0.736842,0.263158,19
6485,1,9,0.100000,0.900000,10
6489,1,20,0.047619,0.952381,21
6491,58,51,0.532110,0.467890,109
6494,6,6,0.500000,0.500000,12
6498,46,29,0.613333,0.386667,75
6506,30,27,0.526316,0.473684,57
6525,5,1,0.833333,0.166667,6
6529,1,1,0.500000,0.500000,2
6530,47,43,0.522222,0.477778,90
6534,34,20,0.629630,0.370370,54
6536,14,2,0.875000,0.125000,16
6538,1,4,0.200000,0.800000,5
6539,29,21,0.580000,0.420000,50
6540,1,2,0.333333,0.666667,3
6542,6,10,0.375000,0.625000,16
6558,6,14,0.300000,0.700000,20
6562,9,0,1.000000,0.000000,9
6565,1,0,1.000000,0.000000,1
6578,16,7,0.695652,0.304348,23
6580,26,8,0.764706,0.235294,34
6582,5,5,0.500000,0.500000,10
6588,1,0,1.000000,0.000000,1
6589,25,19,0.568182,0.431818,44
6592,4,25,0.137931,0.862069,29
6601,65,38,0.631068,0.368932,103
6602,3,0,1.000000,0.000000,3
6603,1,0,1.000000,0.000000,1
6613,1,7,0.125000,0.875000,8
6616,7,3,0.700000,0.300000,10
6620,12,4,0.750000,0.250000,16
6624,25,21,0.543478,0.456522,46
6627,1,0,1.000000,0.000000,1
6633,27,10,0.729730,0.270270,37
6637,0,1,0.000000,1.000000,1
6638,3,4,0.428571,0.571429,7
6641,31,28,0.525424,0.474576,59
6642,2,0,1.000000,0.000000,2
6645,9,6,0.600000,0.400000,15
6648,56,44,0.560000,0.440000,100
6650,22,32,0.407407,0.592593,54
6657,3,4,0.428571,0.571429,7
6661,22,12,0.647059,0.352941,34
6662,5,10,0.333333,0.666667,15
6671,4,3,0.571429,0.428571,7
6672,1,1,0.500000,0.500000,2
6677,9,4,0.692308,0.307692,13
6681,65,26,0.714286,0.285714,91
6682,5,4,0.555556,0.444444,9
6685,78,30,0.722222,0.277778,108
6687,49,1,0.980000,0.020000,50
6690,6,1,0.857143,0.142857,7
6694,44,50,0.468085,0.531915,94
6695,26,12,0.684211,0.315789,38
6697,5,1,0.833333,0.166667,6
6698,20,22,0.476190,0.523810,42
6699,4,2,0.666667,0.333333,6
6705,1,1,0.500000,0.500000,2
6707,1,0,1.000000,0.000000,1
6711,1,0,1.000000,0.000000,1
6713,1,4,0.200000,0.800000,5
1119,37,44,0.456790,0.543210,81
6717,7,3,0.700000,0.300000,10
6718,9,8,0.529412,0.470588,17
6724,4,11,0.266667,0.733333,15
6731,7,2,0.777778,0.222222,9
6734,1,3,0.250000,0.750000,4
6736,2,2,0.500000,0.500000,4
6738,27,32,0.457627,0.542373,59
6739,7,9,0.437500,0.562500,16
6743,32,40,0.444444,0.555556,72
6758,30,14,0.681818,0.318182,44
6760,1,0,1.000000,0.000000,1
6761,2,0,1.000000,0.000000,2
6763,8,18,0.307692,0.692308,26
6767,1,4,0.200000,0.800000,5
6769,0,1,0.000000,1.000000,1
6771,29,45,0.391892,0.608108,74
6779,2,1,0.666667,0.333333,3
6783,16,92,0.148148,0.851852,108
6785,4,16,0.200000,0.800000,20
6789,2,3,0.400000,0.600000,5
6791,1,0,1.000000,0.000000,1
9324,1,7,0.125000,0.875000,8
6794,59,16,0.786667,0.213333,75
6799,1,1,0.500000,0.500000,2
6804,1,6,0.142857,0.857143,7
6807,36,12,0.750000,0.250000,48
6814,0,1,0.000000,1.000000,1
6815,1,2,0.333333,0.666667,3
6816,0,1,0.000000,1.000000,1
6820,49,20,0.710145,0.289855,69
6828,21,9,0.700000,0.300000,30
6829,20,23,0.465116,0.534884,43
6830,3,10,0.230769,0.769231,13
6836,6,3,0.666667,0.333333,9
6838,52,44,0.541667,0.458333,96
10697,13,18,0.419355,0.580645,31
6844,1,1,0.500000,0.500000,2
6847,36,14,0.720000,0.280000,50
6850,19,17,0.527778,0.472222,36
6852,3,2,0.600000,0.400000,5
6854,60,35,0.631579,0.368421,95
6857,4,12,0.250000,0.750000,16
6872,2,2,0.500000,0.500000,4
6878,1,2,0.333333,0.666667,3
6880,36,2,0.947368,0.052632,38
6889,34,15,0.693878,0.306122,49
6890,11,9,0.550000,0.450000,20
6895,2,0,1.000000,0.000000,2
6896,26,44,0.371429,0.628571,70
6901,1,1,0.500000,0.500000,2
6904,16,22,0.421053,0.578947,38
6923,26,6,0.812500,0.187500,32
6925,1,0,1.000000,0.000000,1
6929,9,22,0.290323,0.709677,31
6930,1,17,0.055556,0.944444,18
6931,3,4,0.428571,0.571429,7
6938,9,48,0.157895,0.842105,57
6939,36,14,0.720000,0.280000,50
6945,35,9,0.795455,0.204545,44
6948,58,11,0.840580,0.159420,69
6949,34,8,0.809524,0.190476,42
6951,2,1,0.666667,0.333333,3
6953,1,0,1.000000,0.000000,1
6962,4,6,0.400000,0.600000,10
6971,25,25,0.500000,0.500000,50
6984,42,58,0.420000,0.580000,100
6992,15,3,0.833333,0.166667,18
6993,1,1,0.500000,0.500000,2
6995,24,18,0.571429,0.428571,42
7002,3,63,0.045455,0.954545,66
7007,21,4,0.840000,0.160000,25
7010,13,13,0.500000,0.500000,26
7012,15,17,0.468750,0.531250,32
7014,10,5,0.666667,0.333333,15
7017,40,18,0.689655,0.310345,58
7018,34,43,0.441558,0.558442,77
10727,1,1,0.500000,0.500000,2
7021,2,1,0.666667,0.333333,3
7022,1,0,1.000000,0.000000,1
7025,1,2,0.333333,0.666667,3
7028,14,7,0.666667,0.333333,21
7037,2,0,1.000000,0.000000,2
7039,4,8,0.333333,0.666667,12
7042,1,0,1.000000,0.000000,1
7045,4,6,0.400000,0.600000,10
7047,2,4,0.333333,0.666667,6
7060,13,13,0.500000,0.500000,26
7063,16,56,0.222222,0.777778,72
7064,7,7,0.500000,0.500000,14
7065,0,1,0.000000,1.000000,1
7073,6,7,0.461538,0.538462,13
7080,4,6,0.400000,0.600000,10
7086,1,7,0.125000,0.875000,8
7088,4,6,0.400000,0.600000,10
7090,14,12,0.538462,0.461538,26
7094,1,1,0.500000,0.500000,2
7102,4,2,0.666667,0.333333,6
7111,0,2,0.000000,1.000000,2
7116,1,1,0.500000,0.500000,2
7117,2,2,0.500000,0.500000,4
7118,63,31,0.670213,0.329787,94
7133,21,33,0.388889,0.611111,54
7136,18,4,0.818182,0.181818,22
7155,42,32,0.567568,0.432432,74
7160,1,1,0.500000,0.500000,2
7162,5,4,0.555556,0.444444,9
7167,8,0,1.000000,0.000000,8
7170,34,3,0.918919,0.081081,37
7173,11,4,0.733333,0.266667,15
7182,2,3,0.400000,0.600000,5
7185,1,2,0.333333,0.666667,3
7189,7,9,0.437500,0.562500,16
7190,9,9,0.500000,0.500000,18
7196,2,1,0.666667,0.333333,3
7202,1,3,0.250000,0.750000,4
7207,15,4,0.789474,0.210526,19
7219,3,2,0.600000,0.400000,5
7220,51,51,0.500000,0.500000,102
7224,2,10,0.166667,0.833333,12
7228,2,0,1.000000,0.000000,2
7231,1,1,0.500000,0.500000,2
7232,1,4,0.200000,0.800000,5
7237,34,19,0.641509,0.358491,53
7238,40,1,0.975610,0.024390,41
7239,15,22,0.405405,0.594595,37
7248,3,1,0.750000,0.250000,4
7260,1,0,1.000000,0.000000,1
7261,8,13,0.380952,0.619048,21
7264,52,23,0.693333,0.306667,75
7266,5,16,0.238095,0.761905,21
7272,1,0,1.000000,0.000000,1
7273,5,2,0.714286,0.285714,7
7277,2,6,0.250000,0.750000,8
7282,17,19,0.472222,0.527778,36
7283,1,1,0.500000,0.500000,2
7289,1,2,0.333333,0.666667,3
7291,9,14,0.391304,0.608696,23
7294,1,0,1.000000,0.000000,1
7296,1,0,1.000000,0.000000,1
7302,8,15,0.347826,0.652174,23
7307,3,1,0.750000,0.250000,4
7308,17,2,0.894737,0.105263,19
7309,8,1,0.888889,0.111111,9
7317,52,60,0.464286,0.535714,112
7322,1,1,0.500000,0.500000,2
7327,1,1,0.500000,0.500000,2
7331,1,1,0.500000,0.500000,2
7336,31,48,0.392405,0.607595,79
7348,1,3,0.250000,0.750000,4
7349,45,55,0.450000,0.550000,100
7353,11,10,0.523810,0.476190,21
7354,30,2,0.937500,0.062500,32
7355,28,4,0.875000,0.125000,32
7357,2,3,0.400000,0.600000,5
7358,5,5,0.500000,0.500000,10
7359,11,1,0.916667,0.083333,12
7365,21,0,1.000000,0.000000,21
7380,3,1,0.750000,0.250000,4
7384,3,1,0.750000,0.250000,4
7388,3,0,1.000000,0.000000,3
7389,33,12,0.733333,0.266667,45
7393,2,1,0.666667,0.333333,3
7398,2,0,1.000000,0.000000,2
7399,36,19,0.654545,0.345455,55
7407,0,6,0.000000,1.000000,6
7409,9,33,0.214286,0.785714,42
7411,43,13,0.767857,0.232143,56
7420,19,3,0.863636,0.136364,22
7422,8,8,0.500000,0.500000,16
7423,18,5,0.782609,0.217391,23
7425,2,52,0.037037,0.962963,54
7433,29,13,0.690476,0.309524,42
7437,4,0,1.000000,0.000000,4
7438,1,1,0.500000,0.500000,2
7439,3,4,0.428571,0.571429,7
7441,16,37,0.301887,0.698113,53
7442,1,0,1.000000,0.000000,1
7450,29,40,0.420290,0.579710,69
7456,6,1,0.857143,0.142857,7
7462,43,22,0.661538,0.338462,65
7464,1,1,0.500000,0.500000,2
7472,22,31,0.415094,0.584906,53
7473,11,14,0.440000,0.560000,25
7476,15,45,0.250000,0.750000,60
7482,2,8,0.200000,0.800000,10
9439,11,6,0.647059,0.352941,17
7484,10,0,1.000000,0.000000,10
7485,1,0,1.000000,0.000000,1
7488,4,14,0.222222,0.777778,18
7496,62,51,0.548673,0.451327,113
7500,8,22,0.266667,0.733333,30
7505,0,1,0.000000,1.000000,1
7509,44,55,0.444444,0.555556,99
7511,0,2,0.000000,1.000000,2
7514,1,0,1.000000,0.000000,1
7516,4,7,0.363636,0.636364,11
7518,1,0,1.000000,0.000000,1
7519,0,2,0.000000,1.000000,2
7523,36,20,0.642857,0.357143,56
7531,8,38,0.173913,0.826087,46
7532,5,7,0.416667,0.583333,12
7534,77,38,0.669565,0.330435,115
7540,13,1,0.928571,0.071429,14
7543,44,30,0.594595,0.405405,74
7545,1,2,0.333333,0.666667,3
7554,34,30,0.531250,0.468750,64
7557,1,2,0.333333,0.666667,3
7563,4,9,0.307692,0.692308,13
7567,1,0,1.000000,0.000000,1
7572,46,49,0.484211,0.515789,95
7576,2,8,0.200000,0.800000,10
7578,2,1,0.666667,0.333333,3
7580,1,4,0.200000,0.800000,5
7583,0,7,0.000000,1.000000,7
7588,1,0,1.000000,0.000000,1
7589,12,10,0.545455,0.454545,22
7591,66,50,0.568966,0.431034,116
7595,1,0,1.000000,0.000000,1
7602,21,10,0.677419,0.322581,31
7604,41,38,0.518987,0.481013,79
7613,48,36,0.571429,0.428571,84
7614,21,9,0.700000,0.300000,30
7615,17,4,0.809524,0.190476,21
7617,2,66,0.029412,0.970588,68
7618,1,1,0.500000,0.500000,2
7620,0,1,0.000000,1.000000,1
7624,1,1,0.500000,0.500000,2
7625,41,7,0.854167,0.145833,48
7627,2,0,1.000000,0.000000,2
7631,49,2,0.960784,0.039216,51
7642,2,0,1.000000,0.000000,2
7652,4,0,1.000000,0.000000,4
7653,3,4,0.428571,0.571429,7
7658,1,0,1.000000,0.000000,1
7660,0,3,0.000000,1.000000,3
7661,6,11,0.352941,0.647059,17
7662,13,5,0.722222,0.277778,18
7664,54,21,0.720000,0.280000,75
7665,8,6,0.571429,0.428571,14
7669,0,4,0.000000,1.000000,4
7676,10,8,0.555556,0.444444,18
7677,27,12,0.692308,0.307692,39
7679,4,3,0.571429,0.428571,7
7687,13,28,0.317073,0.682927,41
7689,41,25,0.621212,0.378788,66
7690,2,0,1.000000,0.000000,2
7699,59,16,0.786667,0.213333,75
7701,20,8,0.714286,0.285714,28
7703,44,34,0.564103,0.435897,78
7706,13,0,1.000000,0.000000,13
7712,4,10,0.285714,0.714286,14
7715,10,28,0.263158,0.736842,38
7718,13,35,0.270833,0.729167,48
7724,1,1,0.500000,0.500000,2
7727,10,35,0.222222,0.777778,45
7729,41,9,0.820000,0.180000,50
7731,2,2,0.500000,0.500000,4
7737,58,15,0.794521,0.205479,73
7740,7,6,0.538462,0.461538,13
7746,21,18,0.538462,0.461538,39
7750,4,1,0.800000,0.200000,5
7751,6,5,0.545455,0.454545,11
7752,1,12,0.076923,0.923077,13
7753,39,2,0.951220,0.048780,41
7758,43,23,0.651515,0.348485,66
7764,50,39,0.561798,0.438202,89
7767,1,0,1.000000,0.000000,1
7769,62,30,0.673913,0.326087,92
7780,25,18,0.581395,0.418605,43
7781,25,53,0.320513,0.679487,78
9489,2,5,0.285714,0.714286,7
7787,34,19,0.641509,0.358491,53
7794,26,29,0.472727,0.527273,55
7799,4,8,0.333333,0.666667,12
7800,2,4,0.333333,0.666667,6
7802,29,49,0.371795,0.628205,78
7803,49,2,0.960784,0.039216,51
7805,1,3,0.250000,0.750000,4
7815,4,2,0.666667,0.333333,6
7817,17,4,0.809524,0.190476,21
7825,1,0,1.000000,0.000000,1
7827,1,0,1.000000,0.000000,1
7833,1,2,0.333333,0.666667,3
7838,7,18,0.280000,0.720000,25
7839,1,0,1.000000,0.000000,1
7847,29,29,0.500000,0.500000,58
7848,2,0,1.000000,0.000000,2
7850,17,22,0.435897,0.564103,39
7856,4,2,0.666667,0.333333,6
7858,42,31,0.575342,0.424658,73
7869,1,0,1.000000,0.000000,1
7874,2,1,0.666667,0.333333,3
7878,1,1,0.500000,0.500000,2
7886,2,2,0.500000,0.500000,4
7888,17,2,0.894737,0.105263,19
7889,0,1,0.000000,1.000000,1
7890,8,27,0.228571,0.771429,35
7892,1,13,0.071429,0.928571,14
7895,2,0,1.000000,0.000000,2
7896,36,21,0.631579,0.368421,57
7899,29,2,0.935484,0.064516,31
7902,11,3,0.785714,0.214286,14
7905,2,0,1.000000,0.000000,2
7906,3,1,0.750000,0.250000,4
7909,4,7,0.363636,0.636364,11
7913,2,0,1.000000,0.000000,2
7915,2,6,0.250000,0.750000,8
7916,1,2,0.333333,0.666667,3
7917,2,5,0.285714,0.714286,7
7918,2,0,1.000000,0.000000,2
7924,15,22,0.405405,0.594595,37
7926,1,0,1.000000,0.000000,1
7929,2,3,0.400000,0.600000,5
7930,85,7,0.923913,0.076087,92
7933,1,0,1.000000,0.000000,1
7934,3,12,0.200000,0.800000,15
7946,1,19,0.050000,0.950000,20
7952,1,2,0.333333,0.666667,3
7956,2,1,0.666667,0.333333,3
7963,2,2,0.500000,0.500000,4
7968,1,4,0.200000,0.800000,5
7972,1,16,0.058824,0.941176,17
7973,63,30,0.677419,0.322581,93
7974,1,0,1.000000,0.000000,1
7975,12,5,0.705882,0.294118,17
7976,56,25,0.691358,0.308642,81
7980,4,2,0.666667,0.333333,6
7987,46,14,0.766667,0.233333,60
7991,1,2,0.333333,0.666667,3
7992,24,51,0.320000,0.680000,75
7993,2,10,0.166667,0.833333,12
8000,8,3,0.727273,0.272727,11
8001,27,7,0.794118,0.205882,34
8002,3,4,0.428571,0.571429,7
8004,36,10,0.782609,0.217391,46
8005,65,30,0.684211,0.315789,95
8013,6,1,0.857143,0.142857,7
8021,46,70,0.396552,0.603448,116
8023,1,3,0.250000,0.750000,4
8026,6,2,0.750000,0.250000,8
8034,3,12,0.200000,0.800000,15
8037,0,1,0.000000,1.000000,1
8047,22,8,0.733333,0.266667,30
8049,6,5,0.545455,0.454545,11
8052,38,7,0.844444,0.155556,45
8054,9,0,1.000000,0.000000,9
8056,5,2,0.714286,0.285714,7
8067,0,1,0.000000,1.000000,1
8072,21,7,0.750000,0.250000,28
8074,0,1,0.000000,1.000000,1
8079,1,0,1.000000,0.000000,1
8084,11,12,0.478261,0.521739,23
8085,38,29,0.567164,0.432836,67
8092,45,61,0.424528,0.575472,106
8093,2,5,0.285714,0.714286,7
8094,52,15,0.776119,0.223881,67
8101,13,4,0.764706,0.235294,17
8103,3,2,0.600000,0.400000,5
8107,1,9,0.100000,0.900000,10
8110,0,2,0.000000,1.000000,2
8112,6,1,0.857143,0.142857,7
8116,11,5,0.687500,0.312500,16
8119,32,7,0.820513,0.179487,39
8128,1,0,1.000000,0.000000,1
8129,5,2,0.714286,0.285714,7
8130,17,9,0.653846,0.346154,26
8136,49,12,0.803279,0.196721,61
8142,2,7,0.222222,0.777778,9
8149,0,1,0.000000,1.000000,1
8151,3,21,0.125000,0.875000,24
8153,12,18,0.400000,0.600000,30
8155,8,5,0.615385,0.384615,13
8158,27,16,0.627907,0.372093,43
8161,6,2,0.750000,0.250000,8
8163,57,36,0.612903,0.387097,93
8172,5,14,0.263158,0.736842,19
8174,18,11,0.620690,0.379310,29
8175,11,1,0.916667,0.083333,12
8176,11,20,0.354839,0.645161,31
8177,1,2,0.333333,0.666667,3
8180,2,3,0.400000,0.600000,5
8190,33,5,0.868421,0.131579,38
