id,NumOfCur,NumOfIncur,PerOfCur,PerOfIncur,NumOfVotes
1,2057,702,0.745560,0.254440,2759
2,963,397,0.708088,0.291912,1360
3,136832,108436,0.557888,0.442112,245268
4,3393,952,0.780898,0.219102,4345
5,128,87,0.595349,0.404651,215
6,657,275,0.704936,0.295064,932
7,3165,1520,0.675560,0.324440,4685
8,133,100,0.570815,0.429185,233
8202,3,12,0.200000,0.800000,15
8205,45,19,0.703125,0.296875,64
15,5,1,0.833333,0.166667,6
8208,1,0,1.000000,0.000000,1
8211,6,2,0.750000,0.250000,8
8212,6,10,0.375000,0.625000,16
8213,1,14,0.066667,0.933333,15
8214,481,152,0.759874,0.240126,633
24,550,379,0.592034,0.407966,929
25,6,0,1.000000,0.000000,6
26,179,92,0.660517,0.339483,271
34,28,17,0.622222,0.377778,45
8229,3,22,0.120000,0.880000,25
8238,0,1,0.000000,1.000000,1
8240,10,3,0.769231,0.230769,13
53,3,10,0.230769,0.769231,13
8246,11,13,0.458333,0.541667,24
55,148,183,0.447130,0.552870,331
8255,3,4,0.428571,0.571429,7
8256,86,60,0.589041,0.410959,146
8257,32,14,0.695652,0.304348,46
8259,71,82,0.464052,0.535948,153
70,8,1,0.888889,0.111111,9
8264,1,39,0.025000,0.975000,40
73,2,6,0.250000,0.750000,8
8276,16,40,0.285714,0.714286,56
8277,0,1,0.000000,1.000000,1
8278,167,28,0.856410,0.143590,195
8279,58,126,0.315217,0.684783,184
88,2,2,0.500000,0.500000,4
8282,74,114,0.393617,0.606383,188
91,436,233,0.651719,0.348281,669
8286,30,77,0.280374,0.719626,107
97,980,315,0.756757,0.243243,1295
8290,75,94,0.443787,0.556213,169
8291,1,22,0.043478,0.956522,23
100,769,291,0.725472,0.274528,1060
8293,8,2,0.800000,0.200000,10
8296,1,12,0.076923,0.923077,13
105,564,448,0.557312,0.442688,1012
107,170,52,0.765766,0.234234,222
8300,1,0,1.000000,0.000000,1
8302,78,93,0.456140,0.543860,171
8303,1,1,0.500000,0.500000,2
112,284,73,0.795518,0.204482,357
113,1,0,1.000000,0.000000,1
8306,4,11,0.266667,0.733333,15
8309,1,0,1.000000,0.000000,1
8311,23,8,0.741935,0.258065,31
8312,4,5,0.444444,0.555556,9
124,6,2,0.750000,0.250000,8
126,2,0,1.000000,0.000000,2
128,5,5,0.500000,0.500000,10
8321,1,0,1.000000,0.000000,1
8322,1,1,0.500000,0.500000,2
8325,0,3,0.000000,1.000000,3
136,9,2,0.818182,0.181818,11
141,17,18,0.485714,0.514286,35
8334,785,204,0.793731,0.206269,989
143,19,11,0.633333,0.366667,30
8336,40,84,0.322581,0.677419,124
8338,4,0,1.000000,0.000000,4
8339,1,0,1.000000,0.000000,1
9582,20,18,0.526316,0.473684,38
8217,1,0,1.000000,0.000000,1
8344,5,1,0.833333,0.166667,6
154,13,10,0.565217,0.434783,23
156,8,1,0.888889,0.111111,9
159,225,161,0.582902,0.417098,386
161,20,32,0.384615,0.615385,52
8357,1,1,0.500000,0.500000,2
167,70,30,0.700000,0.300000,100
170,771,205,0.789959,0.210041,976
8367,23,42,0.353846,0.646154,65
177,526,176,0.749288,0.250712,702
180,1,3,0.250000,0.750000,4
8373,5,12,0.294118,0.705882,17
8378,1,0,1.000000,0.000000,1
8380,6,1,0.857143,0.142857,7
191,436,211,0.673879,0.326121,647
8386,3,1,0.750000,0.250000,4
8392,171,85,0.667969,0.332031,256
8399,291,169,0.632609,0.367391,460
209,209,105,0.665605,0.334395,314
8403,1,0,1.000000,0.000000,1
215,177,77,0.696850,0.303150,254
216,203,128,0.613293,0.386707,331
217,10,6,0.625000,0.375000,16
8410,164,129,0.559727,0.440273,293
8411,753,433,0.634907,0.365093,1186
220,315,65,0.828947,0.171053,380
221,1,0,1.000000,0.000000,1
8414,36,14,0.720000,0.280000,50
8415,834,583,0.588567,0.411433,1417
233,111,43,0.720779,0.279221,154
236,122,150,0.448529,0.551471,272
8429,83,72,0.535484,0.464516,155
8430,267,273,0.494444,0.505556,540
8434,11,9,0.550000,0.450000,20
8435,2,2,0.500000,0.500000,4
8439,5,8,0.384615,0.615385,13
8443,393,325,0.547354,0.452646,718
8446,0,3,0.000000,1.000000,3
8449,245,326,0.429072,0.570928,571
261,1549,690,0.691827,0.308173,2239
8464,1,0,1.000000,0.000000,1
8468,8,10,0.444444,0.555556,18
8469,1,0,1.000000,0.000000,1
8470,6,5,0.545455,0.454545,11
8473,4,0,1.000000,0.000000,4
8478,1,17,0.055556,0.944444,18
287,30,14,0.681818,0.318182,44
290,1,5,0.166667,0.833333,6
8489,4,4,0.500000,0.500000,8
8491,102,100,0.504950,0.495050,202
8493,1,0,1.000000,0.000000,1
8494,2,5,0.285714,0.714286,7
8495,4,6,0.400000,0.600000,10
8497,6,28,0.176471,0.823529,34
8499,1,10,0.090909,0.909091,11
308,462,237,0.660944,0.339056,699
8505,5,1,0.833333,0.166667,6
8507,545,154,0.779685,0.220315,699
8510,18,16,0.529412,0.470588,34
8512,4,1,0.800000,0.200000,5
8513,17,12,0.586207,0.413793,29
8514,13,83,0.135417,0.864583,96
330,292,92,0.760417,0.239583,384
8247,46,47,0.494624,0.505376,93
333,177,103,0.632143,0.367857,280
335,49,52,0.485149,0.514851,101
8532,318,405,0.439834,0.560166,723
8533,15,17,0.468750,0.531250,32
10377,4,0,1.000000,0.000000,4
8537,1,4,0.200000,0.800000,5
351,2,8,0.200000,0.800000,10
8545,7,2,0.777778,0.222222,9
356,7,8,0.466667,0.533333,15
357,132,58,0.694737,0.305263,190
360,1530,752,0.670465,0.329535,2282
8556,154,107,0.590038,0.409962,261
8557,1,3,0.250000,0.750000,4
8564,1,1,0.500000,0.500000,2
8574,410,369,0.526316,0.473684,779
8575,1,0,1.000000,0.000000,1
8576,50,19,0.724638,0.275362,69
385,357,350,0.504950,0.495050,707
8578,1,19,0.050000,0.950000,20
8582,1,1,0.500000,0.500000,2
8586,1,2,0.333333,0.666667,3
395,38,15,0.716981,0.283019,53
396,8,5,0.615385,0.384615,13
8592,61,68,0.472868,0.527132,129
67,1913,603,0.760334,0.239666,2516
8596,1,0,1.000000,0.000000,1
406,308,99,0.756757,0.243243,407
8601,74,20,0.787234,0.212766,94
8603,15,4,0.789474,0.210526,19
8607,9,6,0.600000,0.400000,15
8262,1,0,1.000000,0.000000,1
425,82,66,0.554054,0.445946,148
427,0,1,0.000000,1.000000,1
428,10,24,0.294118,0.705882,34
8622,13,31,0.295455,0.704545,44
8623,13,41,0.240741,0.759259,54
8625,217,141,0.606145,0.393855,358
8627,1,0,1.000000,0.000000,1
438,2,1,0.666667,0.333333,3
8632,1,0,1.000000,0.000000,1
447,816,230,0.780115,0.219885,1046
449,6,2,0.750000,0.250000,8
8642,37,32,0.536232,0.463768,69
452,22,8,0.733333,0.266667,30
8646,53,46,0.535354,0.464646,99
455,130,56,0.698925,0.301075,186
8648,200,151,0.569801,0.430199,351
8651,39,54,0.419355,0.580645,93
8655,206,108,0.656051,0.343949,314
8660,3,2,0.600000,0.400000,5
475,553,316,0.636364,0.363636,869
8669,6,7,0.461538,0.538462,13
8670,2,3,0.400000,0.600000,5
8674,18,51,0.260870,0.739130,69
490,987,217,0.819767,0.180233,1204
494,394,74,0.841880,0.158120,468
8687,8,4,0.666667,0.333333,12
8688,113,62,0.645714,0.354286,175
8689,6,9,0.400000,0.600000,15
8690,32,12,0.727273,0.272727,44
8700,0,1,0.000000,1.000000,1
512,4,0,1.000000,0.000000,4
518,124,49,0.716763,0.283237,173
8718,1,5,0.166667,0.833333,6
532,10,13,0.434783,0.565217,23
8725,1,18,0.052632,0.947368,19
8726,1,6,0.142857,0.857143,7
537,1,0,1.000000,0.000000,1
8731,212,71,0.749117,0.250883,283
8732,33,5,0.868421,0.131579,38
8735,342,79,0.812352,0.187648,421
8736,62,49,0.558559,0.441441,111
9648,11,8,0.578947,0.421053,19
8740,1,2,0.333333,0.666667,3
8743,41,1,0.976190,0.023810,42
8745,12,1,0.923077,0.076923,13
8746,17,31,0.354167,0.645833,48
557,1,0,1.000000,0.000000,1
8754,18,20,0.473684,0.526316,38
564,1,0,1.000000,0.000000,1
8758,1,0,1.000000,0.000000,1
8759,268,257,0.510476,0.489524,525
8766,141,84,0.626667,0.373333,225
8767,54,29,0.650602,0.349398,83
8768,13,25,0.342105,0.657895,38
8770,3,1,0.750000,0.250000,4
8771,7,13,0.350000,0.650000,20
8775,1,6,0.142857,0.857143,7
8776,50,26,0.657895,0.342105,76
8777,86,28,0.754386,0.245614,114
8779,2,1,0.666667,0.333333,3
8782,13,2,0.866667,0.133333,15
8784,36,4,0.900000,0.100000,40
8786,260,143,0.645161,0.354839,403
8787,298,133,0.691415,0.308585,431
8788,96,198,0.326531,0.673469,294
597,251,187,0.573059,0.426941,438
8792,2,6,0.250000,0.750000,8
8794,9,2,0.818182,0.181818,11
8797,291,126,0.697842,0.302158,417
8802,40,11,0.784314,0.215686,51
612,599,332,0.643394,0.356606,931
616,745,237,0.758656,0.241344,982
9660,31,7,0.815789,0.184211,38
8810,7,23,0.233333,0.766667,30
631,4,9,0.307692,0.692308,13
8824,226,212,0.515982,0.484018,438
8826,2,2,0.500000,0.500000,4
8829,49,28,0.636364,0.363636,77
8831,8,7,0.533333,0.466667,15
8832,6,1,0.857143,0.142857,7
8833,1,1,0.500000,0.500000,2
642,875,324,0.729775,0.270225,1199
8839,114,57,0.666667,0.333333,171
8844,49,7,0.875000,0.125000,56
8845,1,0,1.000000,0.000000,1
8846,26,98,0.209677,0.790323,124
8851,259,90,0.742120,0.257880,349
8856,1,0,1.000000,0.000000,1
8857,6,1,0.857143,0.142857,7
8859,11,28,0.282051,0.717949,39
668,622,143,0.813072,0.186928,765
8861,33,12,0.733333,0.266667,45
8863,77,12,0.865169,0.134831,89
8864,0,1,0.000000,1.000000,1
8304,214,68,0.758865,0.241135,282
8866,15,23,0.394737,0.605263,38
679,2523,714,0.779425,0.220575,3237
8872,1,7,0.125000,0.875000,8
681,9,36,0.200000,0.800000,45
8874,60,75,0.444444,0.555556,135
8876,3,6,0.333333,0.666667,9
114,1,2,0.333333,0.666667,3
688,612,554,0.524871,0.475129,1166
8881,2,0,1.000000,0.000000,2
8882,185,69,0.728346,0.271654,254
693,119,70,0.629630,0.370370,189
694,182,96,0.654676,0.345324,278
8888,4,43,0.085106,0.914894,47
8889,15,74,0.168539,0.831461,89
8890,34,74,0.314815,0.685185,108
8893,1,3,0.250000,0.750000,4
8895,56,34,0.622222,0.377778,90
704,461,296,0.608983,0.391017,757
706,195,100,0.661017,0.338983,295
708,323,70,0.821883,0.178117,393
8907,200,87,0.696864,0.303136,287
8910,2,5,0.285714,0.714286,7
8911,38,12,0.760000,0.240000,50
8912,1,0,1.000000,0.000000,1
8922,2,0,1.000000,0.000000,2
8925,0,1,0.000000,1.000000,1
736,4,4,0.500000,0.500000,8
8930,74,42,0.637931,0.362069,116
739,648,151,0.811014,0.188986,799
740,2,0,1.000000,0.000000,2
741,321,146,0.687366,0.312634,467
8935,170,86,0.664062,0.335938,256
745,6,2,0.750000,0.250000,8
8939,1,0,1.000000,0.000000,1
748,1506,376,0.800213,0.199787,1882
752,28,60,0.318182,0.681818,88
8318,32,9,0.780488,0.219512,41
8952,7,4,0.636364,0.363636,11
8954,14,4,0.777778,0.222222,18
8959,0,1,0.000000,1.000000,1
8962,1,0,1.000000,0.000000,1
8964,1,11,0.083333,0.916667,12
8965,153,59,0.721698,0.278302,212
8967,55,77,0.416667,0.583333,132
8968,217,176,0.552163,0.447837,393
8969,108,29,0.788321,0.211679,137
8970,10,1,0.909091,0.090909,11
8971,3139,3132,0.500558,0.499442,6271
782,1548,328,0.825160,0.174840,1876
8976,56,106,0.345679,0.654321,162
8978,106,18,0.854839,0.145161,124
8979,2,8,0.200000,0.800000,10
8984,18,21,0.461538,0.538462,39
794,5,8,0.384615,0.615385,13
8992,1,0,1.000000,0.000000,1
8994,2,3,0.400000,0.600000,5
8996,32,71,0.310680,0.689320,103
8997,2,1,0.666667,0.333333,3
9000,1,1,0.500000,0.500000,2
9008,1638,5018,0.246094,0.753906,6656
8328,18,7,0.720000,0.280000,25
9013,1,0,1.000000,0.000000,1
829,4,3,0.571429,0.428571,7
9024,0,15,0.000000,1.000000,15
838,67,21,0.761364,0.238636,88
841,1865,660,0.738614,0.261386,2525
842,15,2,0.882353,0.117647,17
845,2,1,0.666667,0.333333,3
9044,10,10,0.500000,0.500000,20
9045,0,3,0.000000,1.000000,3
9046,186,272,0.406114,0.593886,458
860,147,20,0.880240,0.119760,167
10667,1,1,0.500000,0.500000,2
864,2,2,0.500000,0.500000,4
144,18,7,0.720000,0.280000,25
866,638,314,0.670168,0.329832,952
9059,5,26,0.161290,0.838710,31
9060,1,0,1.000000,0.000000,1
9061,98,31,0.759690,0.240310,129
9062,11,48,0.186441,0.813559,59
9063,1,1,0.500000,0.500000,2
9064,41,13,0.759259,0.240741,54
9067,1,10,0.090909,0.909091,11
9068,4,2,0.666667,0.333333,6
9073,13,8,0.619048,0.380952,21
882,7,14,0.333333,0.666667,21
9076,7,1,0.875000,0.125000,8
9077,1,0,1.000000,0.000000,1
9083,1,0,1.000000,0.000000,1
894,23,26,0.469388,0.530612,49
9089,2,4,0.333333,0.666667,6
9091,96,117,0.450704,0.549296,213
901,3,3,0.500000,0.500000,6
9094,259,135,0.657360,0.342640,394
9095,197,228,0.463529,0.536471,425
904,25,12,0.675676,0.324324,37
905,9,6,0.600000,0.400000,15
9098,48,26,0.648649,0.351351,74
9100,11,53,0.171875,0.828125,64
9101,48,30,0.615385,0.384615,78
9107,143,109,0.567460,0.432540,252
917,139,43,0.763736,0.236264,182
9111,16,1,0.941176,0.058824,17
9113,149,95,0.610656,0.389344,244
927,13,17,0.433333,0.566667,30
9122,1,0,1.000000,0.000000,1
931,1,1,0.500000,0.500000,2
9124,103,49,0.677632,0.322368,152
9126,18,16,0.529412,0.470588,34
935,11,8,0.578947,0.421053,19
936,4,1,0.800000,0.200000,5
9129,2,1,0.666667,0.333333,3
941,3,4,0.428571,0.571429,7
9139,4,3,0.571429,0.428571,7
951,27,8,0.771429,0.228571,35
9145,0,1,0.000000,1.000000,1
9146,1,0,1.000000,0.000000,1
9717,64,49,0.566372,0.433628,113
961,4,1,0.800000,0.200000,5
964,997,422,0.702607,0.297393,1419
9162,208,111,0.652038,0.347962,319
971,76,62,0.550725,0.449275,138
9166,1,0,1.000000,0.000000,1
979,62,52,0.543860,0.456140,114
9172,205,185,0.525641,0.474359,390
9173,9,34,0.209302,0.790698,43
9180,20,8,0.714286,0.285714,28
994,246,136,0.643979,0.356021,382
995,131,30,0.813665,0.186335,161
9189,102,95,0.517766,0.482234,197
998,9,10,0.473684,0.526316,19
9191,14,3,0.823529,0.176471,17
9192,1,1,0.500000,0.500000,2
1004,80,35,0.695652,0.304348,115
1007,52,52,0.500000,0.500000,104
9200,16,2,0.888889,0.111111,18
1009,29,11,0.725000,0.275000,40
1011,9,9,0.500000,0.500000,18
9204,1,7,0.125000,0.875000,8
9726,0,2,0.000000,1.000000,2
9208,0,1,0.000000,1.000000,1
9209,11,5,0.687500,0.312500,16
9214,28,51,0.354430,0.645570,79
1026,2,1,0.666667,0.333333,3
1030,2204,525,0.807622,0.192378,2729
9223,10,15,0.400000,0.600000,25
1032,298,141,0.678815,0.321185,439
9225,41,50,0.450549,0.549451,91
9227,18,1,0.947368,0.052632,19
1037,1,0,1.000000,0.000000,1
1038,26,12,0.684211,0.315789,38
9234,27,12,0.692308,0.307692,39
9236,10,8,0.555556,0.444444,18
1049,20,11,0.645161,0.354839,31
1053,2,8,0.200000,0.800000,10
1054,72,41,0.637168,0.362832,113
9248,1,17,0.055556,0.944444,18
9249,10,1,0.909091,0.090909,11
9253,1,2,0.333333,0.666667,3
1063,50,29,0.632911,0.367089,79
9257,10,1,0.909091,0.090909,11
9259,2,1,0.666667,0.333333,3
1073,12,6,0.666667,0.333333,18
9268,34,28,0.548387,0.451613,62
9272,3,1,0.750000,0.250000,4
1082,67,18,0.788235,0.211765,85
9275,253,229,0.524896,0.475104,482
9276,6,1,0.857143,0.142857,7
9277,5,11,0.312500,0.687500,16
9278,2,4,0.333333,0.666667,6
1091,45,15,0.750000,0.250000,60
9295,1,12,0.076923,0.923077,13
1107,122,41,0.748466,0.251534,163
9300,0,6,0.000000,1.000000,6
9303,1,0,1.000000,0.000000,1
1112,8,0,1.000000,0.000000,8
9311,6,18,0.250000,0.750000,24
9313,59,91,0.393333,0.606667,150
9317,302,172,0.637131,0.362869,474
9318,17,1,0.944444,0.055556,18
1127,1,8,0.111111,0.888889,9
9320,8,17,0.320000,0.680000,25
1131,81,114,0.415385,0.584615,195
1132,1408,535,0.724653,0.275347,1943
9331,91,85,0.517045,0.482955,176
9332,1,0,1.000000,0.000000,1
9335,9,33,0.214286,0.785714,42
9339,1,2,0.333333,0.666667,3
1155,86,30,0.741379,0.258621,116
9349,1,4,0.200000,0.800000,5
9350,5,0,1.000000,0.000000,5
9352,4,1,0.800000,0.200000,5
9355,1,1,0.500000,0.500000,2
9356,1,2,0.333333,0.666667,3
9359,0,16,0.000000,1.000000,16
9363,2,17,0.105263,0.894737,19
9364,70,15,0.823529,0.176471,85
9366,31,43,0.418919,0.581081,74
1175,5,2,0.714286,0.285714,7
1176,1,5,0.166667,0.833333,6
1177,33,27,0.550000,0.450000,60
1179,349,162,0.682975,0.317025,511
9375,1,1,0.500000,0.500000,2
1184,3,1,0.750000,0.250000,4
9377,1,2,0.333333,0.666667,3
1188,11,1,0.916667,0.083333,12
9382,112,53,0.678788,0.321212,165
9383,20,6,0.769231,0.230769,26
1192,593,159,0.788564,0.211436,752
9386,4,2,0.666667,0.333333,6
9387,68,33,0.673267,0.326733,101
9392,2,0,1.000000,0.000000,2
9396,4,1,0.800000,0.200000,5
1205,85,47,0.643939,0.356061,132
1207,713,129,0.846793,0.153207,842
9407,3,2,0.600000,0.400000,5
1216,362,101,0.781857,0.218143,463
9409,9,25,0.264706,0.735294,34
9410,9,10,0.473684,0.526316,19
9411,1,1,0.500000,0.500000,2
9412,25,91,0.215517,0.784483,116
9415,8,6,0.571429,0.428571,14
9416,0,10,0.000000,1.000000,10
9420,190,192,0.497382,0.502618,382
9426,1,3,0.250000,0.750000,4
9429,1,1,0.500000,0.500000,2
9431,26,9,0.742857,0.257143,35
9432,76,59,0.562963,0.437037,135
1247,2694,740,0.784508,0.215492,3434
1253,13,6,0.684211,0.315789,19
8401,2,11,0.153846,0.846154,13
9448,1,0,1.000000,0.000000,1
9449,28,68,0.291667,0.708333,96
9450,46,87,0.345865,0.654135,133
9453,108,51,0.679245,0.320755,159
9454,17,6,0.739130,0.260870,23
9455,1,12,0.076923,0.923077,13
1267,90,120,0.428571,0.571429,210
1269,10,14,0.416667,0.583333,24
1271,2,4,0.333333,0.666667,6
9466,1,2,0.333333,0.666667,3
9473,5,2,0.714286,0.285714,7
9475,1,0,1.000000,0.000000,1
9480,2,0,1.000000,0.000000,2
9483,6,10,0.375000,0.625000,16
9485,11,9,0.550000,0.450000,20
9488,58,34,0.630435,0.369565,92
1297,442,211,0.676876,0.323124,653
9493,2,1,0.666667,0.333333,3
9497,1,2,0.333333,0.666667,3
9498,84,52,0.617647,0.382353,136
9499,27,19,0.586957,0.413043,46
9500,21,5,0.807692,0.192308,26
1313,166,206,0.446237,0.553763,372
8412,182,119,0.604651,0.395349,301
1322,9,8,0.529412,0.470588,17
9515,125,73,0.631313,0.368687,198
9778,13,1,0.928571,0.071429,14
1326,0,2,0.000000,1.000000,2
9520,62,17,0.784810,0.215190,79
9521,1,1,0.500000,0.500000,2
1330,2,6,0.250000,0.750000,8
1333,1,5,0.166667,0.833333,6
9528,2,4,0.333333,0.666667,6
9531,1,0,1.000000,0.000000,1
9533,228,168,0.575758,0.424242,396
9536,4,8,0.333333,0.666667,12
9537,256,229,0.527835,0.472165,485
9542,376,492,0.433180,0.566820,868
9545,50,30,0.625000,0.375000,80
9546,2,1,0.666667,0.333333,3
9548,230,168,0.577889,0.422111,398
9550,4,10,0.285714,0.714286,14
9552,44,29,0.602740,0.397260,73
9554,3,14,0.176471,0.823529,17
9555,145,41,0.779570,0.220430,186
9556,1,0,1.000000,0.000000,1
9560,55,40,0.578947,0.421053,95
9561,1,1,0.500000,0.500000,2
9562,180,84,0.681818,0.318182,264
9563,14,13,0.518519,0.481481,27
9565,1,2,0.333333,0.666667,3
1375,310,348,0.471125,0.528875,658
9569,35,82,0.299145,0.700855,117
9571,4,5,0.444444,0.555556,9
9576,166,88,0.653543,0.346457,254
9577,3,5,0.375000,0.625000,8
9578,1795,7228,0.198936,0.801064,9023
9581,2,2,0.500000,0.500000,4
1390,150,93,0.617284,0.382716,243
9583,1,12,0.076923,0.923077,13
1394,5,6,0.454545,0.545455,11
1395,3,0,1.000000,0.000000,3
1397,5,4,0.555556,0.444444,9
9596,1,1,0.500000,0.500000,2
9598,1,2,0.333333,0.666667,3
9599,2,15,0.117647,0.882353,17
9601,1,8,0.111111,0.888889,9
9605,0,4,0.000000,1.000000,4
9608,13,4,0.764706,0.235294,17
1419,49,18,0.731343,0.268657,67
1420,139,75,0.649533,0.350467,214
1422,2,6,0.250000,0.750000,8
9617,0,2,0.000000,1.000000,2
9622,123,79,0.608911,0.391089,202
9623,3,1,0.750000,0.250000,4
9624,36,68,0.346154,0.653846,104
9625,2,3,0.400000,0.600000,5
9626,3,2,0.600000,0.400000,5
1441,28,8,0.777778,0.222222,36
1446,8,14,0.363636,0.636364,22
9642,1,0,1.000000,0.000000,1
1452,4,3,0.571429,0.428571,7
9645,28,65,0.301075,0.698925,93
9647,20,30,0.400000,0.600000,50
1456,67,30,0.690722,0.309278,97
11166,7,6,0.538462,0.461538,13
9656,113,100,0.530516,0.469484,213
9658,1,0,1.000000,0.000000,1
9659,29,24,0.547170,0.452830,53
1468,2,0,1.000000,0.000000,2
9664,17,13,0.566667,0.433333,30
9665,3,5,0.375000,0.625000,8
1475,61,72,0.458647,0.541353,133
9669,8,6,0.571429,0.428571,14
9680,2,16,0.111111,0.888889,18
9681,470,1602,0.226834,0.773166,2072
9682,93,552,0.144186,0.855814,645
9683,34,25,0.576271,0.423729,59
9684,47,45,0.510870,0.489130,92
9686,2,6,0.250000,0.750000,8
9691,0,4,0.000000,1.000000,4
9692,31,56,0.356322,0.643678,87
1501,1068,729,0.594324,0.405676,1797
9695,155,510,0.233083,0.766917,665
9808,69,132,0.343284,0.656716,201
9698,6,8,0.428571,0.571429,14
9700,6,8,0.428571,0.571429,14
9702,2,0,1.000000,0.000000,2
9705,4,1,0.800000,0.200000,5
9706,0,8,0.000000,1.000000,8
9708,51,51,0.500000,0.500000,102
9712,206,117,0.637771,0.362229,323
1523,0,2,0.000000,1.000000,2
1525,163,167,0.493939,0.506061,330
9719,26,2,0.928571,0.071429,28
1528,132,70,0.653465,0.346535,202
9722,1,1,0.500000,0.500000,2
1531,127,49,0.721591,0.278409,176
1534,5,1,0.833333,0.166667,6
9729,0,7,0.000000,1.000000,7
9730,5,4,0.555556,0.444444,9
9731,3,23,0.115385,0.884615,26
9732,625,2370,0.208681,0.791319,2995
1549,20,11,0.645161,0.354839,31
9746,19,4,0.826087,0.173913,23
1555,2,0,1.000000,0.000000,2
9749,5,7,0.416667,0.583333,12
9751,6,34,0.150000,0.850000,40
9752,0,1,0.000000,1.000000,1
1561,4195,900,0.823356,0.176644,5095
9755,2,7,0.222222,0.777778,9
9765,8,3,0.727273,0.272727,11
9768,19,2,0.904762,0.095238,21
9770,1,1,0.500000,0.500000,2
9777,1,1,0.500000,0.500000,2
1586,1,0,1.000000,0.000000,1
9782,7,2,0.777778,0.222222,9
9787,589,2102,0.218878,0.781122,2691
9788,2,25,0.074074,0.925926,27
1603,65,30,0.684211,0.315789,95
9796,145,78,0.650224,0.349776,223
1605,34,26,0.566667,0.433333,60
1607,50,59,0.458716,0.541284,109
1616,16,3,0.842105,0.157895,19
9810,1,1,0.500000,0.500000,2
9811,6,6,0.500000,0.500000,12
9828,12,22,0.352941,0.647059,34
1627,46,44,0.511111,0.488889,90
9820,7,8,0.466667,0.533333,15
1633,3,9,0.250000,0.750000,12
1636,11,13,0.458333,0.541667,24
9835,7,1,0.875000,0.125000,8
9836,1,12,0.076923,0.923077,13
9839,2,0,1.000000,0.000000,2
1653,4887,3613,0.574941,0.425059,8500
9846,36,57,0.387097,0.612903,93
9847,25,17,0.595238,0.404762,42
1657,9,6,0.600000,0.400000,15
1660,2,0,1.000000,0.000000,2
9853,2,2,0.500000,0.500000,4
1669,1718,550,0.757496,0.242504,2268
9865,1,2,0.333333,0.666667,3
9869,1,0,1.000000,0.000000,1
1678,52,24,0.684211,0.315789,76
1687,0,1,0.000000,1.000000,1
1689,563,153,0.786313,0.213687,716
1690,7,1,0.875000,0.125000,8
9884,236,456,0.341040,0.658960,692
9885,2,3,0.400000,0.600000,5
1699,30,38,0.441176,0.558824,68
9894,4,2,0.666667,0.333333,6
9895,3,8,0.272727,0.727273,11
9897,5,35,0.125000,0.875000,40
1706,24,21,0.533333,0.466667,45
1710,1,0,1.000000,0.000000,1
1711,449,126,0.780870,0.219130,575
9906,15,2,0.882353,0.117647,17
9907,1,3,0.250000,0.750000,4
9910,14,7,0.666667,0.333333,21
9911,5,10,0.333333,0.666667,15
9914,11,1,0.916667,0.083333,12
8479,0,5,0.000000,1.000000,5
1726,658,387,0.629665,0.370335,1045
9845,757,2964,0.203440,0.796560,3721
9921,2,2,0.500000,0.500000,4
9922,1,0,1.000000,0.000000,1
1731,27,3,0.900000,0.100000,30
9925,435,1922,0.184557,0.815443,2357
9927,3,0,1.000000,0.000000,3
1736,188,101,0.650519,0.349481,289
9932,1,5,0.166667,0.833333,6
9940,2,2,0.500000,0.500000,4
1749,1,1,0.500000,0.500000,2
9943,1,1,0.500000,0.500000,2
9946,1,0,1.000000,0.000000,1
9954,24,20,0.545455,0.454545,44
9958,3,2,0.600000,0.400000,5
9852,3,4,0.428571,0.571429,7
1773,232,207,0.528474,0.471526,439
9970,7,24,0.225806,0.774194,31
1779,2151,360,0.856631,0.143369,2511
1782,31,18,0.632653,0.367347,49
1783,1,2,0.333333,0.666667,3
9976,9,5,0.642857,0.357143,14
9977,41,9,0.820000,0.180000,50
9978,45,44,0.505618,0.494382,89
9981,35,40,0.466667,0.533333,75
9983,8,13,0.380952,0.619048,21
1792,2,0,1.000000,0.000000,2
1794,29,20,0.591837,0.408163,49
1795,93,167,0.357692,0.642308,260
9991,7,1,0.875000,0.125000,8
1801,57,75,0.431818,0.568182,132
1803,31,21,0.596154,0.403846,52
1805,1,2,0.333333,0.666667,3
10003,0,2,0.000000,1.000000,2
1812,656,388,0.628352,0.371648,1044
1814,2,0,1.000000,0.000000,2
10007,18,24,0.428571,0.571429,42
1816,479,210,0.695210,0.304790,689
10010,1,1,0.500000,0.500000,2
10014,37,18,0.672727,0.327273,55
10016,1,4,0.200000,0.800000,5
1826,1,11,0.083333,0.916667,12
10972,1,0,1.000000,0.000000,1
1836,3,1,0.750000,0.250000,4
1839,7,15,0.318182,0.681818,22
10035,231,138,0.626016,0.373984,369
1849,3357,1020,0.766964,0.233036,4377
1850,7,7,0.500000,0.500000,14
10045,0,2,0.000000,1.000000,2
10046,1,8,0.111111,0.888889,9
10048,1,2,0.333333,0.666667,3
1865,77,42,0.647059,0.352941,119
10058,1,11,0.083333,0.916667,12
1870,2,7,0.222222,0.777778,9
10063,24,13,0.648649,0.351351,37
1872,10,10,0.500000,0.500000,20
10065,2,0,1.000000,0.000000,2
1882,26,36,0.419355,0.580645,62
1894,2,11,0.153846,0.846154,13
10094,18,25,0.418605,0.581395,43
1904,20,5,0.800000,0.200000,25
10099,22,26,0.458333,0.541667,48
10104,1,0,1.000000,0.000000,1
1914,1,0,1.000000,0.000000,1
1916,937,197,0.826279,0.173721,1134
1918,233,86,0.730408,0.269592,319
10112,58,52,0.527273,0.472727,110
1921,127,167,0.431973,0.568027,294
1923,6,13,0.315789,0.684211,19
10116,629,2106,0.229982,0.770018,2735
10117,673,2483,0.213245,0.786755,3156
1926,451,198,0.694915,0.305085,649
321,220,134,0.621469,0.378531,354
10121,13,43,0.232143,0.767857,56
10126,37,30,0.552239,0.447761,67
1935,37,17,0.685185,0.314815,54
1941,661,280,0.702444,0.297556,941
1943,1,0,1.000000,0.000000,1
10136,11,5,0.687500,0.312500,16
10139,4,1,0.800000,0.200000,5
1952,3,1,0.750000,0.250000,4
10145,30,16,0.652174,0.347826,46
1955,183,97,0.653571,0.346429,280
1958,2,0,1.000000,0.000000,2
10161,4,8,0.333333,0.666667,12
1970,80,52,0.606061,0.393939,132
10163,1,2,0.333333,0.666667,3
10165,34,27,0.557377,0.442623,61
1980,263,127,0.674359,0.325641,390
1981,47,6,0.886792,0.113208,53
10177,7,4,0.636364,0.363636,11
10179,24,39,0.380952,0.619048,63
1991,14,15,0.482759,0.517241,29
10184,7,24,0.225806,0.774194,31
1994,918,229,0.800349,0.199651,1147
1998,30,9,0.769231,0.230769,39
10192,2,5,0.285714,0.714286,7
10193,201,140,0.589443,0.410557,341
10197,4,2,0.666667,0.333333,6
9614,1,6,0.142857,0.857143,7
10200,11,15,0.423077,0.576923,26
2011,15,18,0.454545,0.545455,33
10206,5,7,0.416667,0.583333,12
10208,6,1,0.857143,0.142857,7
10210,1,7,0.125000,0.875000,8
10212,16,45,0.262295,0.737705,61
10215,14,9,0.608696,0.391304,23
10217,13,3,0.812500,0.187500,16
10218,7,1,0.875000,0.125000,8
10222,1,0,1.000000,0.000000,1
2031,942,388,0.708271,0.291729,1330
10224,1,0,1.000000,0.000000,1
2033,42,7,0.857143,0.142857,49
2035,1026,323,0.760563,0.239437,1349
2036,6,1,0.857143,0.142857,7
10234,2,0,1.000000,0.000000,2
2043,22,7,0.758621,0.241379,29
10237,1,0,1.000000,0.000000,1
10239,116,112,0.508772,0.491228,228
10240,97,127,0.433036,0.566964,224
10242,22,20,0.523810,0.476190,42
10243,3,14,0.176471,0.823529,17
10247,20,12,0.625000,0.375000,32
10250,6,8,0.428571,0.571429,14
10253,11,2,0.846154,0.153846,13
2062,12,10,0.545455,0.454545,22
2064,66,27,0.709677,0.290323,93
10257,5,11,0.312500,0.687500,16
10258,0,5,0.000000,1.000000,5
2067,1,2,0.333333,0.666667,3
2069,13,41,0.240741,0.759259,54
10266,1,0,1.000000,0.000000,1
10269,15,20,0.428571,0.571429,35
10272,5,23,0.178571,0.821429,28
10273,1,0,1.000000,0.000000,1
10275,6,17,0.260870,0.739130,23
10277,19,3,0.863636,0.136364,22
10280,2,0,1.000000,0.000000,2
10281,1,3,0.250000,0.750000,4
10284,2,0,1.000000,0.000000,2
2095,0,1,0.000000,1.000000,1
2096,6,6,0.500000,0.500000,12
10290,7,12,0.368421,0.631579,19
10291,1,13,0.071429,0.928571,14
2101,2,15,0.117647,0.882353,17
10295,82,32,0.719298,0.280702,114
10297,1,7,0.125000,0.875000,8
2106,6,7,0.461538,0.538462,13
8543,6,1,0.857143,0.142857,7
2109,9,15,0.375000,0.625000,24
2115,2,7,0.222222,0.777778,9
10310,19,104,0.154472,0.845528,123
10318,1,8,0.111111,0.888889,9
10321,4,5,0.444444,0.555556,9
10322,2,4,0.333333,0.666667,6
10327,18,1,0.947368,0.052632,19
2140,30,24,0.555556,0.444444,54
2147,1,0,1.000000,0.000000,1
10342,83,40,0.674797,0.325203,123
10343,112,66,0.629213,0.370787,178
10355,1,5,0.166667,0.833333,6
10356,1,3,0.250000,0.750000,4
2166,12291,36649,0.251144,0.748856,48940
2170,31,47,0.397436,0.602564,78
9347,21,24,0.466667,0.533333,45
10373,28,38,0.424242,0.575758,66
10374,13,35,0.270833,0.729167,48
10375,2,0,1.000000,0.000000,2
2185,7,1,0.875000,0.125000,8
10378,26,49,0.346667,0.653333,75
10379,10,21,0.322581,0.677419,31
10380,63,92,0.406452,0.593548,155
10384,3,5,0.375000,0.625000,8
10385,507,980,0.340955,0.659045,1487
10387,20,10,0.666667,0.333333,30
10391,50,66,0.431034,0.568966,116
10392,2,5,0.285714,0.714286,7
2201,13,1,0.928571,0.071429,14
10405,0,1,0.000000,1.000000,1
2218,1790,351,0.836058,0.163942,2141
10414,0,1,0.000000,1.000000,1
2226,10,11,0.476190,0.523810,21
10419,0,2,0.000000,1.000000,2
10420,5,1,0.833333,0.166667,6
2230,43,15,0.741379,0.258621,58
10427,0,1,0.000000,1.000000,1
2238,6,15,0.285714,0.714286,21
2243,1669,602,0.734919,0.265081,2271
2245,9,7,0.562500,0.437500,16
10444,0,1,0.000000,1.000000,1
2256,0,3,0.000000,1.000000,3
2261,1,7,0.125000,0.875000,8
2264,1,0,1.000000,0.000000,1
2265,193,88,0.686833,0.313167,281
10459,4,3,0.571429,0.428571,7
2271,1444,403,0.781808,0.218192,1847
10466,0,4,0.000000,1.000000,4
10469,1,5,0.166667,0.833333,6
2282,0,3,0.000000,1.000000,3
10475,34,27,0.557377,0.442623,61
2284,719,202,0.780673,0.219327,921
10477,1,0,1.000000,0.000000,1
10479,5,10,0.333333,0.666667,15
10480,2,2,0.500000,0.500000,4
10486,8,23,0.258065,0.741935,31
10489,2,22,0.083333,0.916667,24
10492,2,4,0.333333,0.666667,6
10495,1,1,0.500000,0.500000,2
8577,1,2,0.333333,0.666667,3
10504,2,2,0.500000,0.500000,4
2313,0,1,0.000000,1.000000,1
2315,2,2,0.500000,0.500000,4
10509,1,0,1.000000,0.000000,1
10511,1,1,0.500000,0.500000,2
10513,1,5,0.166667,0.833333,6
2322,1,1,0.500000,0.500000,2
2323,2,1,0.666667,0.333333,3
2325,75,31,0.707547,0.292453,106
10519,9,11,0.450000,0.550000,20
10521,8,16,0.333333,0.666667,24
10523,11,0,1.000000,0.000000,11
10527,17,9,0.653846,0.346154,26
2340,610,244,0.714286,0.285714,854
10536,0,3,0.000000,1.000000,3
10540,0,4,0.000000,1.000000,4
2349,4,1,0.800000,0.200000,5
2350,60,80,0.428571,0.571429,140
10550,1,0,1.000000,0.000000,1
11316,2,0,1.000000,0.000000,2
10556,10,6,0.625000,0.375000,16
8587,30,14,0.681818,0.318182,44
10569,1,6,0.142857,0.857143,7
10571,2,0,1.000000,0.000000,2
2383,3,1,0.750000,0.250000,4
2384,1,1,0.500000,0.500000,2
10578,3,2,0.600000,0.400000,5
10579,1,0,1.000000,0.000000,1
2388,6,8,0.428571,0.571429,14
2394,7,5,0.583333,0.416667,12
10589,1,3,0.250000,0.750000,4
2400,2,5,0.285714,0.714286,7
2401,19,52,0.267606,0.732394,71
10594,1,2,0.333333,0.666667,3
11323,1,1,0.500000,0.500000,2
2405,1,4,0.200000,0.800000,5
10607,33,22,0.600000,0.400000,55
10608,6,4,0.600000,0.400000,10
2417,63,128,0.329843,0.670157,191
2419,2,2,0.500000,0.500000,4
10612,4,24,0.142857,0.857143,28
2421,4,5,0.444444,0.555556,9
9961,5,4,0.555556,0.444444,9
10618,1,1,0.500000,0.500000,2
10624,2,0,1.000000,0.000000,2
10626,55,29,0.654762,0.345238,84
10631,0,4,0.000000,1.000000,4
2448,714,340,0.677419,0.322581,1054
10644,5,1,0.833333,0.166667,6
10646,17,7,0.708333,0.291667,24
2455,252,138,0.646154,0.353846,390
2458,136,72,0.653846,0.346154,208
10652,1,4,0.200000,0.800000,5
2463,43,3,0.934783,0.065217,46
10656,8,1,0.888889,0.111111,9
2466,0,1,0.000000,1.000000,1
2468,119,53,0.691860,0.308140,172
2472,2048,566,0.783474,0.216526,2614
10665,14,3,0.823529,0.176471,17
2475,154,80,0.658120,0.341880,234
10669,1,0,1.000000,0.000000,1
10670,134,185,0.420063,0.579937,319
2481,38,23,0.622951,0.377049,61
9971,1,2,0.333333,0.666667,3
10676,16,8,0.666667,0.333333,24
2486,0,1,0.000000,1.000000,1
2487,14,12,0.538462,0.461538,26
10683,1,0,1.000000,0.000000,1
10692,19,0,1.000000,0.000000,19
2505,1,3,0.250000,0.750000,4
2506,450,258,0.635593,0.364407,708
2510,5,3,0.625000,0.375000,8
10705,15,3,0.833333,0.166667,18
2515,1,2,0.333333,0.666667,3
10712,0,7,0.000000,1.000000,7
10725,8,7,0.533333,0.466667,15
2535,17,7,0.708333,0.291667,24
10728,1,0,1.000000,0.000000,1
2537,465,253,0.647632,0.352368,718
10731,14,4,0.777778,0.222222,18
8617,19,6,0.760000,0.240000,25
2556,4,18,0.181818,0.818182,22
10750,0,1,0.000000,1.000000,1
2559,21,22,0.488372,0.511628,43
10765,6,15,0.285714,0.714286,21
10768,5,2,0.714286,0.285714,7
9987,1,0,1.000000,0.000000,1
2583,32,55,0.367816,0.632184,87
2585,2,3,0.400000,0.600000,5
2589,61,76,0.445255,0.554745,137
2592,2806,536,0.839617,0.160383,3342
10787,8,1,0.888889,0.111111,9
10796,2,1,0.666667,0.333333,3
10806,1,1,0.500000,0.500000,2
10807,1,1,0.500000,0.500000,2
2622,673,191,0.778935,0.221065,864
10818,3,2,0.600000,0.400000,5
10822,1,0,1.000000,0.000000,1
2634,4,6,0.400000,0.600000,10
10829,8,4,0.666667,0.333333,12
9997,2,0,1.000000,0.000000,2
10836,2,1,0.666667,0.333333,3
2649,23,65,0.261364,0.738636,88
2652,3,1,0.750000,0.250000,4
2654,23,12,0.657143,0.342857,35
10847,13,10,0.565217,0.434783,23
2667,180,31,0.853081,0.146919,211
2672,1,8,0.111111,0.888889,9
10873,8,7,0.533333,0.466667,15
10876,0,1,0.000000,1.000000,1
8641,194,57,0.772908,0.227092,251
2696,445,116,0.793226,0.206774,561
2697,32,33,0.492308,0.507692,65
10897,2,0,1.000000,0.000000,2
10899,2,3,0.400000,0.600000,5
10901,1,1,0.500000,0.500000,2
2711,664,461,0.590222,0.409778,1125
10907,1,6,0.142857,0.857143,7
10909,16,1,0.941176,0.058824,17
10911,1,1,0.500000,0.500000,2
10917,15,1,0.937500,0.062500,16
10922,1,1,0.500000,0.500000,2
8647,1,5,0.166667,0.833333,6
2733,157,28,0.848649,0.151351,185
2741,1,0,1.000000,0.000000,1
2750,4023,1171,0.774548,0.225452,5194
10945,2,2,0.500000,0.500000,4
2754,2,3,0.400000,0.600000,5
10950,1,0,1.000000,0.000000,1
2759,871,263,0.768078,0.231922,1134
2763,2,2,0.500000,0.500000,4
10018,8,16,0.333333,0.666667,24
10959,36,48,0.428571,0.571429,84
9367,1,4,0.200000,0.800000,5
10973,6,1,0.857143,0.142857,7
2799,73,39,0.651786,0.348214,112
2807,15,19,0.441176,0.558824,34
2813,564,390,0.591195,0.408805,954
11006,8,8,0.500000,0.500000,16
11011,40,49,0.449438,0.550562,89
2825,1,1,0.500000,0.500000,2
2828,49,22,0.690141,0.309859,71
11022,2,8,0.200000,0.800000,10
11024,8,9,0.470588,0.529412,17
2834,383,242,0.612800,0.387200,625
2835,1042,326,0.761696,0.238304,1368
11029,1,0,1.000000,0.000000,1
9369,195,130,0.600000,0.400000,325
11036,0,4,0.000000,1.000000,4
11043,5,0,1.000000,0.000000,5
11047,3,1,0.750000,0.250000,4
2860,283,241,0.540076,0.459924,524
2861,130,112,0.537190,0.462810,242
11054,1,1,0.500000,0.500000,2
2872,1,0,1.000000,0.000000,1
2874,1360,334,0.802834,0.197166,1694
11069,1,0,1.000000,0.000000,1
2883,2,1,0.666667,0.333333,3
11079,1,3,0.250000,0.750000,4
2888,97,132,0.423581,0.576419,229
2889,1440,467,0.755113,0.244887,1907
11082,14,8,0.636364,0.363636,22
11090,21,21,0.500000,0.500000,42
2903,985,231,0.810033,0.189967,1216
11105,2,3,0.400000,0.600000,5
2914,0,1,0.000000,1.000000,1
11109,9,4,0.692308,0.307692,13
11110,2,0,1.000000,0.000000,2
11113,3,10,0.230769,0.769231,13
2933,3,4,0.428571,0.571429,7
2934,14,8,0.636364,0.363636,22
2949,1,0,1.000000,0.000000,1
2961,38,20,0.655172,0.344828,58
2967,79,38,0.675214,0.324786,117
2974,3,3,0.500000,0.500000,6
2976,128,146,0.467153,0.532847,274
11176,3,3,0.500000,0.500000,6
2998,1,4,0.200000,0.800000,5
11196,1,1,0.500000,0.500000,2
3009,77,41,0.652542,0.347458,118
3012,347,189,0.647388,0.352612,536
3031,40,32,0.555556,0.444444,72
11234,10,12,0.454545,0.545455,22
3054,0,16,0.000000,1.000000,16
3068,162,92,0.637795,0.362205,254
3076,1,2,0.333333,0.666667,3
3085,5,6,0.454545,0.545455,11
3098,46,38,0.547619,0.452381,84
3099,145,82,0.638767,0.361233,227
10074,1,1,0.500000,0.500000,2
3108,32,16,0.666667,0.333333,48
11302,1,0,1.000000,0.000000,1
11305,2,0,1.000000,0.000000,2
3114,1,0,1.000000,0.000000,1
3124,1,6,0.142857,0.857143,7
3131,0,1,0.000000,1.000000,1
11343,1,0,1.000000,0.000000,1
3153,376,186,0.669039,0.330961,562
11366,4,2,0.666667,0.333333,6
8289,138,119,0.536965,0.463035,257
3185,210,171,0.551181,0.448819,381
3189,24,27,0.470588,0.529412,51
3191,15,72,0.172414,0.827586,87
3208,2,0,1.000000,0.000000,2
3217,127,86,0.596244,0.403756,213
10096,1,0,1.000000,0.000000,1
543,146,52,0.737374,0.262626,198
11020,28,25,0.528302,0.471698,53
10106,2,3,0.400000,0.600000,5
10110,4,13,0.235294,0.764706,17
10113,7,5,0.583333,0.416667,12
8749,600,231,0.722022,0.277978,831
1925,526,235,0.691196,0.308804,761
10119,181,1084,0.143083,0.856917,1265
10127,40,38,0.512821,0.487179,78
579,0,1,0.000000,1.000000,1
595,45,25,0.642857,0.357143,70
8789,101,86,0.540107,0.459893,187
8305,7,4,0.636364,0.363636,11
9397,12,13,0.480000,0.520000,25
10771,2,7,0.222222,0.777778,9
8865,75,89,0.457317,0.542683,164
8873,30,12,0.714286,0.285714,42
4108,86,14,0.860000,0.140000,100
4116,3,2,0.600000,0.400000,5
4120,38,20,0.655172,0.344828,58
4128,6,7,0.461538,0.538462,13
4141,5,2,0.714286,0.285714,7
4146,2073,815,0.717798,0.282202,2888
4149,30,12,0.714286,0.285714,42
4150,0,4,0.000000,1.000000,4
4159,29,22,0.568627,0.431373,51
4162,458,279,0.621438,0.378562,737
4175,0,16,0.000000,1.000000,16
4181,1,0,1.000000,0.000000,1
4184,6,4,0.600000,0.400000,10
4187,2,5,0.285714,0.714286,7
4190,3075,1198,0.719635,0.280365,4273
4196,5,1,0.833333,0.166667,6
1228,193,132,0.593846,0.406154,325
4200,2,15,0.117647,0.882353,17
4217,1,0,1.000000,0.000000,1
10261,12,3,0.800000,0.200000,15
4240,653,272,0.705946,0.294054,925
4257,667,248,0.728962,0.271038,915
4264,435,142,0.753899,0.246101,577
4277,20,21,0.487805,0.512195,41
4295,1,0,1.000000,0.000000,1
4299,14,33,0.297872,0.702128,47
4302,27,8,0.771429,0.228571,35
4303,3,7,0.300000,0.700000,10
4325,38,10,0.791667,0.208333,48
4328,1231,453,0.730998,0.269002,1684
4330,192,133,0.590769,0.409231,325
4340,20,9,0.689655,0.310345,29
4355,1462,369,0.798471,0.201529,1831
4362,2,2,0.500000,0.500000,4
4375,55,63,0.466102,0.533898,118
4381,46,70,0.396552,0.603448,116
4393,3484,640,0.844811,0.155189,4124
4395,1319,776,0.629594,0.370406,2095
4405,1,0,1.000000,0.000000,1
4411,13,3,0.812500,0.187500,16
10293,4,0,1.000000,0.000000,4
4418,26,4,0.866667,0.133333,30
4419,103,142,0.420408,0.579592,245
4428,80,131,0.379147,0.620853,211
4435,2,2,0.500000,0.500000,4
8932,7,32,0.179487,0.820513,39
8933,0,1,0.000000,1.000000,1
4455,3,1,0.750000,0.250000,4
4458,231,159,0.592308,0.407692,390
4460,54,36,0.600000,0.400000,90
4463,334,193,0.633776,0.366224,527
4468,113,126,0.472803,0.527197,239
4473,23,13,0.638889,0.361111,36
8940,1,0,1.000000,0.000000,1
4491,612,236,0.721698,0.278302,848
10307,9,1,0.900000,0.100000,10
8944,338,160,0.678715,0.321285,498
4517,1,0,1.000000,0.000000,1
4523,1001,220,0.819820,0.180180,1221
4531,1,1,0.500000,0.500000,2
4556,3,3,0.500000,0.500000,6
4567,4,2,0.666667,0.333333,6
4569,2,10,0.166667,0.833333,12
4571,1029,334,0.754952,0.245048,1363
4573,183,127,0.590323,0.409677,310
4592,2,11,0.153846,0.846154,13
4598,119,64,0.650273,0.349727,183
4601,220,231,0.487805,0.512195,451
4608,5,5,0.500000,0.500000,10
4610,4,12,0.250000,0.750000,16
4625,24,12,0.666667,0.333333,36
4630,1,9,0.100000,0.900000,10
4634,3,3,0.500000,0.500000,6
4642,2,1,0.666667,0.333333,3
4656,190,168,0.530726,0.469274,358
4690,88,157,0.359184,0.640816,245
4693,1,1,0.500000,0.500000,2
4694,194,147,0.568915,0.431085,341
4715,903,426,0.679458,0.320542,1329
4720,4,25,0.137931,0.862069,29
4726,13,17,0.433333,0.566667,30
4727,14,33,0.297872,0.702128,47
10254,14,11,0.560000,0.440000,25
4912,159,157,0.503165,0.496835,316
4919,30,39,0.434783,0.565217,69
4922,21,15,0.583333,0.416667,36
4938,1,3,0.250000,0.750000,4
4953,1,0,1.000000,0.000000,1
4954,40,22,0.645161,0.354839,62
4961,4,1,0.800000,0.200000,5
4978,445,127,0.777972,0.222028,572
4983,2,0,1.000000,0.000000,2
4987,15,17,0.468750,0.531250,32
4992,163,128,0.560137,0.439863,291
5021,1,6,0.142857,0.857143,7
5044,135,59,0.695876,0.304124,194
5046,1630,626,0.722518,0.277482,2256
5052,2,4,0.333333,0.666667,6
5055,5,3,0.625000,0.375000,8
6715,19,13,0.593750,0.406250,32
5063,9,0,1.000000,0.000000,9
9037,98,66,0.597561,0.402439,164
5094,7,10,0.411765,0.588235,17
11081,5,0,1.000000,0.000000,5
5118,1,6,0.142857,0.857143,7
5127,84,167,0.334661,0.665339,251
5149,13,1,0.928571,0.071429,14
5162,13,4,0.764706,0.235294,17
5170,94,22,0.810345,0.189655,116
5174,928,700,0.570025,0.429975,1628
5189,15,45,0.250000,0.750000,60
5196,935,329,0.739715,0.260285,1264
5200,2,3,0.400000,0.600000,5
5201,13,18,0.419355,0.580645,31
5202,4,8,0.333333,0.666667,12
5208,8,13,0.380952,0.619048,21
5209,11,13,0.458333,0.541667,24
5215,18,43,0.295082,0.704918,61
5217,13,12,0.520000,0.480000,25
5220,1,2,0.333333,0.666667,3
5222,4,3,0.571429,0.428571,7
5230,17,9,0.653846,0.346154,26
5240,1,0,1.000000,0.000000,1
5241,218,77,0.738983,0.261017,295
5258,2,19,0.095238,0.904762,21
5259,1,0,1.000000,0.000000,1
5263,1265,532,0.703951,0.296049,1797
10435,23,8,0.741935,0.258065,31
5280,82,87,0.485207,0.514793,169
5292,2093,719,0.744310,0.255690,2812
5293,389,133,0.745211,0.254789,522
5300,5,6,0.454545,0.545455,11
5311,0,1,0.000000,1.000000,1
5313,274,107,0.719160,0.280840,381
5314,22,17,0.564103,0.435897,39
5319,15,24,0.384615,0.615385,39
5343,1,1,0.500000,0.500000,2
5347,113,75,0.601064,0.398936,188
5367,61,40,0.603960,0.396040,101
5371,281,139,0.669048,0.330952,420
5387,13,29,0.309524,0.690476,42
5390,121,73,0.623711,0.376289,194
9093,1,1,0.500000,0.500000,2
5410,1,1,0.500000,0.500000,2
9096,5,1,0.833333,0.166667,6
5441,921,332,0.735036,0.264964,1253
5456,1,0,1.000000,0.000000,1
10474,4,3,0.571429,0.428571,7
5511,1330,371,0.781893,0.218107,1701
5520,3,0,1.000000,0.000000,3
5538,433,379,0.533251,0.466749,812
5545,57,61,0.483051,0.516949,118
5557,5,1,0.833333,0.166667,6
5558,13,7,0.650000,0.350000,20
9119,1,0,1.000000,0.000000,1
5572,147,251,0.369347,0.630653,398
5575,5,6,0.454545,0.545455,11
8369,8,4,0.666667,0.333333,12
5586,544,467,0.538081,0.461919,1011
9123,1,0,1.000000,0.000000,1
5600,5,7,0.416667,0.583333,12
9461,8,15,0.347826,0.652174,23
5619,10,15,0.400000,0.600000,25
5623,455,162,0.737439,0.262561,617
5638,1341,899,0.598661,0.401339,2240
5639,53,38,0.582418,0.417582,91
9133,106,115,0.479638,0.520362,221
5652,2082,1560,0.571664,0.428336,3642
5660,124,81,0.604878,0.395122,205
10503,0,2,0.000000,1.000000,2
5678,66,93,0.415094,0.584906,159
5689,650,400,0.619048,0.380952,1050
5706,5,6,0.454545,0.545455,11
5707,502,113,0.816260,0.183740,615
5727,13,20,0.393939,0.606061,33
5733,278,80,0.776536,0.223464,358
5743,1,1,0.500000,0.500000,2
10515,2,0,1.000000,0.000000,2
5754,1435,585,0.710396,0.289604,2020
5756,121,45,0.728916,0.271084,166
10517,6,2,0.750000,0.250000,8
5057,1,3,0.250000,0.750000,4
5792,2,0,1.000000,0.000000,2
5803,738,525,0.584323,0.415677,1263
5805,440,172,0.718954,0.281046,612
970,907,284,0.761545,0.238455,1191
5851,0,2,0.000000,1.000000,2
9171,70,20,0.777778,0.222222,90
5890,1,0,1.000000,0.000000,1
5892,8,2,0.800000,0.200000,10
5902,1,0,1.000000,0.000000,1
5906,1,4,0.200000,0.800000,5
5909,85,21,0.801887,0.198113,106
5948,1533,623,0.711039,0.288961,2156
5950,77,34,0.693694,0.306306,111
5955,5,6,0.454545,0.545455,11
5956,32,4,0.888889,0.111111,36
9186,2,2,0.500000,0.500000,4
5971,60,83,0.419580,0.580420,143
5983,6,20,0.230769,0.769231,26
9190,14,20,0.411765,0.588235,34
5995,1,1,0.500000,0.500000,2
5997,575,155,0.787671,0.212329,730
6039,45,39,0.535714,0.464286,84
6043,342,132,0.721519,0.278481,474
6055,2,2,0.500000,0.500000,4
6062,232,519,0.308921,0.691079,751
8931,17,18,0.485714,0.514286,35
6072,1865,705,0.725681,0.274319,2570
6073,2,1,0.666667,0.333333,3
6076,2,3,0.400000,0.600000,5
9205,18,1,0.947368,0.052632,19
6088,3,1,0.750000,0.250000,4
6094,143,103,0.581301,0.418699,246
10575,5,1,0.833333,0.166667,6
6116,47,21,0.691176,0.308824,68
6124,19,9,0.678571,0.321429,28
6139,3,2,0.600000,0.400000,5
6153,41,15,0.732143,0.267857,56
6156,60,79,0.431655,0.568345,139
9218,5,16,0.238095,0.761905,21
6159,1316,414,0.760694,0.239306,1730
6160,4,2,0.666667,0.333333,6
6162,174,185,0.484680,0.515320,359
6167,1783,830,0.682357,0.317643,2613
6172,2409,790,0.753048,0.246952,3199
9753,0,1,0.000000,1.000000,1
6198,402,187,0.682513,0.317487,589
6223,37,4,0.902439,0.097561,41
6230,29,21,0.580000,0.420000,50
6237,1,1,0.500000,0.500000,2
10028,1,2,0.333333,0.666667,3
10301,7,5,0.583333,0.416667,12
6268,382,298,0.561765,0.438235,680
6274,12,13,0.480000,0.520000,25
6282,12,8,0.600000,0.400000,20
6287,34,32,0.515152,0.484848,66
6288,1,1,0.500000,0.500000,2
6316,597,415,0.589921,0.410079,1012
9246,3,1,0.750000,0.250000,4
6348,146,134,0.521429,0.478571,280
6369,66,58,0.532258,0.467742,124
6390,0,1,0.000000,1.000000,1
6413,65,62,0.511811,0.488189,127
6414,8,5,0.615385,0.384615,13
6419,1,0,1.000000,0.000000,1
6427,325,113,0.742009,0.257991,438
6434,2,13,0.133333,0.866667,15
6437,1,1,0.500000,0.500000,2
6447,24,55,0.303797,0.696203,79
6449,276,128,0.683168,0.316832,404
6450,201,47,0.810484,0.189516,248
6456,358,177,0.669159,0.330841,535
6460,618,415,0.598258,0.401742,1033
6461,40,19,0.677966,0.322034,59
6462,8,1,0.888889,0.111111,9
6463,7,7,0.500000,0.500000,14
6469,3,3,0.500000,0.500000,6
6470,7,21,0.250000,0.750000,28
6472,5,8,0.384615,0.615385,13
6473,40,35,0.533333,0.466667,75
6476,75,82,0.477707,0.522293,157
6482,909,337,0.729535,0.270465,1246
6483,14,5,0.736842,0.263158,19
6484,787,270,0.744560,0.255440,1057
6485,1,9,0.100000,0.900000,10
6486,2451,705,0.776616,0.223384,3156
6488,1327,511,0.721980,0.278020,1838
6489,1,20,0.047619,0.952381,21
6491,58,51,0.532110,0.467890,109
6493,537,121,0.816109,0.183891,658
6494,6,6,0.500000,0.500000,12
6495,71,63,0.529851,0.470149,134
6498,46,29,0.613333,0.386667,75
6499,26,99,0.208000,0.792000,125
6506,30,27,0.526316,0.473684,57
6507,116,30,0.794521,0.205479,146
6509,70,121,0.366492,0.633508,191
6522,72,80,0.473684,0.526316,152
6524,1122,570,0.663121,0.336879,1692
6525,5,1,0.833333,0.166667,6
6526,373,181,0.673285,0.326715,554
6529,1,1,0.500000,0.500000,2
6530,47,43,0.522222,0.477778,90
6534,34,20,0.629630,0.370370,54
6536,14,2,0.875000,0.125000,16
6537,759,249,0.752976,0.247024,1008
6538,1,4,0.200000,0.800000,5
6539,29,21,0.580000,0.420000,50
6540,1,2,0.333333,0.666667,3
6542,6,10,0.375000,0.625000,16
6547,1885,893,0.678546,0.321454,2778
6549,909,317,0.741436,0.258564,1226
6554,73,72,0.503448,0.496552,145
6558,6,14,0.300000,0.700000,20
6562,9,0,1.000000,0.000000,9
6565,1,0,1.000000,0.000000,1
6577,544,296,0.647619,0.352381,840
6578,16,7,0.695652,0.304348,23
6580,26,8,0.764706,0.235294,34
6582,5,5,0.500000,0.500000,10
6588,1,0,1.000000,0.000000,1
6589,25,19,0.568182,0.431818,44
6592,4,25,0.137931,0.862069,29
6593,206,148,0.581921,0.418079,354
6598,81,127,0.389423,0.610577,208
6601,65,38,0.631068,0.368932,103
6602,3,0,1.000000,0.000000,3
6603,1,0,1.000000,0.000000,1
6604,102,21,0.829268,0.170732,123
6609,449,220,0.671151,0.328849,669
6610,418,314,0.571038,0.428962,732
6613,1,7,0.125000,0.875000,8
6616,7,3,0.700000,0.300000,10
6618,398,122,0.765385,0.234615,520
6620,12,4,0.750000,0.250000,16
6623,312,102,0.753623,0.246377,414
6624,25,21,0.543478,0.456522,46
6627,1,0,1.000000,0.000000,1
6633,27,10,0.729730,0.270270,37
6637,0,1,0.000000,1.000000,1
6638,3,4,0.428571,0.571429,7
6641,31,28,0.525424,0.474576,59
6642,2,0,1.000000,0.000000,2
6645,9,6,0.600000,0.400000,15
6648,56,44,0.560000,0.440000,100
6650,22,32,0.407407,0.592593,54
6657,3,4,0.428571,0.571429,7
6659,1233,659,0.651691,0.348309,1892
6661,22,12,0.647059,0.352941,34
6662,5,10,0.333333,0.666667,15
6670,86,83,0.508876,0.491124,169
6671,4,3,0.571429,0.428571,7
6672,1,1,0.500000,0.500000,2
6676,485,325,0.598765,0.401235,810
6677,9,4,0.692308,0.307692,13
6681,65,26,0.714286,0.285714,91
6682,5,4,0.555556,0.444444,9
6683,69,64,0.518797,0.481203,133
6685,78,30,0.722222,0.277778,108
6687,49,1,0.980000,0.020000,50
6690,6,1,0.857143,0.142857,7
6694,44,50,0.468085,0.531915,94
6695,26,12,0.684211,0.315789,38
6697,5,1,0.833333,0.166667,6
6698,20,22,0.476190,0.523810,42
6699,4,2,0.666667,0.333333,6
6705,1,1,0.500000,0.500000,2
6707,1,0,1.000000,0.000000,1
6711,1,0,1.000000,0.000000,1
6713,1,4,0.200000,0.800000,5
6714,123,91,0.574766,0.425234,214
1119,37,44,0.456790,0.543210,81
6717,7,3,0.700000,0.300000,10
6718,9,8,0.529412,0.470588,17
6719,321,137,0.700873,0.299127,458
6722,593,320,0.649507,0.350493,913
6724,4,11,0.266667,0.733333,15
6731,7,2,0.777778,0.222222,9
6732,94,108,0.465347,0.534653,202
6734,1,3,0.250000,0.750000,4
6735,249,77,0.763804,0.236196,326
6736,2,2,0.500000,0.500000,4
6737,139,39,0.780899,0.219101,178
6738,27,32,0.457627,0.542373,59
6739,7,9,0.437500,0.562500,16
6743,32,40,0.444444,0.555556,72
8408,75,57,0.568182,0.431818,132
6754,134,57,0.701571,0.298429,191
6758,30,14,0.681818,0.318182,44
6760,1,0,1.000000,0.000000,1
6761,2,0,1.000000,0.000000,2
6763,8,18,0.307692,0.692308,26
6767,1,4,0.200000,0.800000,5
6769,0,1,0.000000,1.000000,1
6771,29,45,0.391892,0.608108,74
6772,284,140,0.669811,0.330189,424
6773,831,248,0.770158,0.229842,1079
6779,2,1,0.666667,0.333333,3
6783,16,92,0.148148,0.851852,108
6785,4,16,0.200000,0.800000,20
6786,2605,1235,0.678385,0.321615,3840
6788,175,359,0.327715,0.672285,534
6789,2,3,0.400000,0.600000,5
6791,1,0,1.000000,0.000000,1
9324,1,7,0.125000,0.875000,8
6794,59,16,0.786667,0.213333,75
6796,429,216,0.665116,0.334884,645
6799,1,1,0.500000,0.500000,2
6800,169,90,0.652510,0.347490,259
6802,79,146,0.351111,0.648889,225
6804,1,6,0.142857,0.857143,7
6807,36,12,0.750000,0.250000,48
6814,0,1,0.000000,1.000000,1
6815,1,2,0.333333,0.666667,3
6816,0,1,0.000000,1.000000,1
6820,49,20,0.710145,0.289855,69
6823,310,79,0.796915,0.203085,389
6828,21,9,0.700000,0.300000,30
6829,20,23,0.465116,0.534884,43
6830,3,10,0.230769,0.769231,13
6835,182,69,0.725100,0.274900,251
6836,6,3,0.666667,0.333333,9
6838,52,44,0.541667,0.458333,96
10697,13,18,0.419355,0.580645,31
6843,81,39,0.675000,0.325000,120
6844,1,1,0.500000,0.500000,2
6847,36,14,0.720000,0.280000,50
6849,1097,363,0.751370,0.248630,1460
6850,19,17,0.527778,0.472222,36
6852,3,2,0.600000,0.400000,5
6854,60,35,0.631579,0.368421,95
6857,4,12,0.250000,0.750000,16
6859,66,55,0.545455,0.454545,121
6872,2,2,0.500000,0.500000,4
6873,2091,577,0.783733,0.216267,2668
6876,42,96,0.304348,0.695652,138
6878,1,2,0.333333,0.666667,3
6880,36,2,0.947368,0.052632,38
6889,34,15,0.693878,0.306122,49
6890,11,9,0.550000,0.450000,20
6895,2,0,1.000000,0.000000,2
6896,26,44,0.371429,0.628571,70
6901,1,1,0.500000,0.500000,2
6904,16,22,0.421053,0.578947,38
6914,455,429,0.514706,0.485294,884
6917,176,112,0.611111,0.388889,288
6923,26,6,0.812500,0.187500,32
6924,105,37,0.739437,0.260563,142
6925,1,0,1.000000,0.000000,1
6926,179,151,0.542424,0.457576,330
6928,1525,412,0.787300,0.212700,1937
6929,9,22,0.290323,0.709677,31
6930,1,17,0.055556,0.944444,18
6931,3,4,0.428571,0.571429,7
6938,9,48,0.157895,0.842105,57
6939,36,14,0.720000,0.280000,50
6943,98,114,0.462264,0.537736,212
6944,443,263,0.627479,0.372521,706
6945,35,9,0.795455,0.204545,44
6948,58,11,0.840580,0.159420,69
6949,34,8,0.809524,0.190476,42
6951,2,1,0.666667,0.333333,3
6953,1,0,1.000000,0.000000,1
6962,4,6,0.400000,0.600000,10
6966,174,256,0.404651,0.595349,430
6967,228,106,0.682635,0.317365,334
6968,99,70,0.585799,0.414201,169
6969,159,142,0.528239,0.471761,301
6971,25,25,0.500000,0.500000,50
6981,77,121,0.388889,0.611111,198
6983,481,412,0.538634,0.461366,893
6984,42,58,0.420000,0.580000,100
6987,770,414,0.650338,0.349662,1184
6992,15,3,0.833333,0.166667,18
6993,1,1,0.500000,0.500000,2
6994,109,66,0.622857,0.377143,175
6995,24,18,0.571429,0.428571,42
7002,3,63,0.045455,0.954545,66
7007,21,4,0.840000,0.160000,25
7010,13,13,0.500000,0.500000,26
7012,15,17,0.468750,0.531250,32
7014,10,5,0.666667,0.333333,15
7017,40,18,0.689655,0.310345,58
7018,34,43,0.441558,0.558442,77
10727,1,1,0.500000,0.500000,2
7020,95,104,0.477387,0.522613,199
7021,2,1,0.666667,0.333333,3
7022,1,0,1.000000,0.000000,1
7025,1,2,0.333333,0.666667,3
7028,14,7,0.666667,0.333333,21
7037,2,0,1.000000,0.000000,2
7039,4,8,0.333333,0.666667,12
7040,1640,567,0.743090,0.256910,2207
7042,1,0,1.000000,0.000000,1
7044,85,121,0.412621,0.587379,206
7045,4,6,0.400000,0.600000,10
7047,2,4,0.333333,0.666667,6
7051,140,127,0.524345,0.475655,267
7052,124,45,0.733728,0.266272,169
7060,13,13,0.500000,0.500000,26
7063,16,56,0.222222,0.777778,72
7064,7,7,0.500000,0.500000,14
7065,0,1,0.000000,1.000000,1
7069,781,792,0.496503,0.503497,1573
7073,6,7,0.461538,0.538462,13
7075,209,62,0.771218,0.228782,271
7080,4,6,0.400000,0.600000,10
7086,1,7,0.125000,0.875000,8
7088,4,6,0.400000,0.600000,10
7090,14,12,0.538462,0.461538,26
7092,1516,1797,0.457591,0.542409,3313
7094,1,1,0.500000,0.500000,2
7102,4,2,0.666667,0.333333,6
7109,569,200,0.739922,0.260078,769
7111,0,2,0.000000,1.000000,2
7116,1,1,0.500000,0.500000,2
7117,2,2,0.500000,0.500000,4
7118,63,31,0.670213,0.329787,94
7125,914,365,0.714621,0.285379,1279
7126,102,66,0.607143,0.392857,168
7128,301,216,0.582205,0.417795,517
7132,396,181,0.686308,0.313692,577
7133,21,33,0.388889,0.611111,54
7135,565,199,0.739529,0.260471,764
7136,18,4,0.818182,0.181818,22
7138,145,52,0.736041,0.263959,197
7139,684,309,0.688822,0.311178,993
7141,193,206,0.483709,0.516291,399
7144,739,228,0.764219,0.235781,967
7148,145,78,0.650224,0.349776,223
7155,42,32,0.567568,0.432432,74
7156,979,296,0.767843,0.232157,1275
7160,1,1,0.500000,0.500000,2
7162,5,4,0.555556,0.444444,9
7166,370,140,0.725490,0.274510,510
7167,8,0,1.000000,0.000000,8
7170,34,3,0.918919,0.081081,37
7173,11,4,0.733333,0.266667,15
7179,124,48,0.720930,0.279070,172
7182,2,3,0.400000,0.600000,5
7183,188,100,0.652778,0.347222,288
7185,1,2,0.333333,0.666667,3
7186,59,108,0.353293,0.646707,167
7189,7,9,0.437500,0.562500,16
7190,9,9,0.500000,0.500000,18
7191,868,343,0.716763,0.283237,1211
7193,231,234,0.496774,0.503226,465
7195,202,117,0.633229,0.366771,319
7196,2,1,0.666667,0.333333,3
7198,1389,706,0.663007,0.336993,2095
7202,1,3,0.250000,0.750000,4
7203,223,126,0.638968,0.361032,349
7207,15,4,0.789474,0.210526,19
7213,2069,1644,0.557231,0.442769,3713
7217,243,125,0.660326,0.339674,368
7219,3,2,0.600000,0.400000,5
7220,51,51,0.500000,0.500000,102
7224,2,10,0.166667,0.833333,12
7225,362,246,0.595395,0.404605,608
7226,86,48,0.641791,0.358209,134
7227,792,529,0.599546,0.400454,1321
7228,2,0,1.000000,0.000000,2
7230,365,312,0.539143,0.460857,677
7231,1,1,0.500000,0.500000,2
7232,1,4,0.200000,0.800000,5
7233,114,96,0.542857,0.457143,210
7236,155,105,0.596154,0.403846,260
7237,34,19,0.641509,0.358491,53
7238,40,1,0.975610,0.024390,41
7239,15,22,0.405405,0.594595,37
7244,85,123,0.408654,0.591346,208
7248,3,1,0.750000,0.250000,4
7249,134,99,0.575107,0.424893,233
7253,566,356,0.613883,0.386117,922
7256,555,280,0.664671,0.335329,835
7260,1,0,1.000000,0.000000,1
7261,8,13,0.380952,0.619048,21
7262,437,175,0.714052,0.285948,612
7264,52,23,0.693333,0.306667,75
7266,5,16,0.238095,0.761905,21
7272,1,0,1.000000,0.000000,1
7273,5,2,0.714286,0.285714,7
7277,2,6,0.250000,0.750000,8
7282,17,19,0.472222,0.527778,36
7283,1,1,0.500000,0.500000,2
7289,1,2,0.333333,0.666667,3
7291,9,14,0.391304,0.608696,23
7293,139,161,0.463333,0.536667,300
7294,1,0,1.000000,0.000000,1
7296,1,0,1.000000,0.000000,1
7302,8,15,0.347826,0.652174,23
7307,3,1,0.750000,0.250000,4
7308,17,2,0.894737,0.105263,19
7309,8,1,0.888889,0.111111,9
7317,52,60,0.464286,0.535714,112
7322,1,1,0.500000,0.500000,2
7327,1,1,0.500000,0.500000,2
7331,1,1,0.500000,0.500000,2
7336,31,48,0.392405,0.607595,79
7348,1,3,0.250000,0.750000,4
7349,45,55,0.450000,0.550000,100
7350,177,133,0.570968,0.429032,310
7353,11,10,0.523810,0.476190,21
7354,30,2,0.937500,0.062500,32
7355,28,4,0.875000,0.125000,32
7357,2,3,0.400000,0.600000,5
7358,5,5,0.500000,0.500000,10
7359,11,1,0.916667,0.083333,12
7360,94,63,0.598726,0.401274,157
7365,21,0,1.000000,0.000000,21
7366,355,173,0.672348,0.327652,528
7368,95,79,0.545977,0.454023,174
7369,501,226,0.689133,0.310867,727
7380,3,1,0.750000,0.250000,4
7384,3,1,0.750000,0.250000,4
7385,466,180,0.721362,0.278638,646
7386,296,120,0.711538,0.288462,416
7388,3,0,1.000000,0.000000,3
7389,33,12,0.733333,0.266667,45
7393,2,1,0.666667,0.333333,3
7395,133,52,0.718919,0.281081,185
7398,2,0,1.000000,0.000000,2
7399,36,19,0.654545,0.345455,55
7400,275,585,0.319767,0.680233,860
7407,0,6,0.000000,1.000000,6
7409,9,33,0.214286,0.785714,42
7411,43,13,0.767857,0.232143,56
7419,214,106,0.668750,0.331250,320
7420,19,3,0.863636,0.136364,22
7422,8,8,0.500000,0.500000,16
7423,18,5,0.782609,0.217391,23
7425,2,52,0.037037,0.962963,54
7428,324,203,0.614801,0.385199,527
7433,29,13,0.690476,0.309524,42
7437,4,0,1.000000,0.000000,4
7438,1,1,0.500000,0.500000,2
7439,3,4,0.428571,0.571429,7
7441,16,37,0.301887,0.698113,53
7442,1,0,1.000000,0.000000,1
7448,385,360,0.516779,0.483221,745
7450,29,40,0.420290,0.579710,69
7456,6,1,0.857143,0.142857,7
7461,124,87,0.587678,0.412322,211
7462,43,22,0.661538,0.338462,65
7464,1,1,0.500000,0.500000,2
7468,112,69,0.618785,0.381215,181
7471,69,66,0.511111,0.488889,135
7472,22,31,0.415094,0.584906,53
7473,11,14,0.440000,0.560000,25
7476,15,45,0.250000,0.750000,60
7478,359,155,0.698444,0.301556,514
7479,43,89,0.325758,0.674242,132
7482,2,8,0.200000,0.800000,10
9439,11,6,0.647059,0.352941,17
7484,10,0,1.000000,0.000000,10
7485,1,0,1.000000,0.000000,1
7488,4,14,0.222222,0.777778,18
7491,1349,570,0.702970,0.297030,1919
7494,1177,844,0.582385,0.417615,2021
7496,62,51,0.548673,0.451327,113
7498,119,70,0.629630,0.370370,189
7500,8,22,0.266667,0.733333,30
7505,0,1,0.000000,1.000000,1
7509,44,55,0.444444,0.555556,99
7511,0,2,0.000000,1.000000,2
7514,1,0,1.000000,0.000000,1
7516,4,7,0.363636,0.636364,11
7518,1,0,1.000000,0.000000,1
7519,0,2,0.000000,1.000000,2
7523,36,20,0.642857,0.357143,56
7531,8,38,0.173913,0.826087,46
7532,5,7,0.416667,0.583333,12
7534,77,38,0.669565,0.330435,115
7535,135,87,0.608108,0.391892,222
7536,259,127,0.670984,0.329016,386
7537,49,89,0.355072,0.644928,138
7540,13,1,0.928571,0.071429,14
7543,44,30,0.594595,0.405405,74
7545,1,2,0.333333,0.666667,3
7549,230,144,0.614973,0.385027,374
7553,63,70,0.473684,0.526316,133
7554,34,30,0.531250,0.468750,64
7555,349,154,0.693837,0.306163,503
7557,1,2,0.333333,0.666667,3
7562,97,91,0.515957,0.484043,188
7563,4,9,0.307692,0.692308,13
7567,1,0,1.000000,0.000000,1
7572,46,49,0.484211,0.515789,95
7575,114,392,0.225296,0.774704,506
7576,2,8,0.200000,0.800000,10
7578,2,1,0.666667,0.333333,3
7579,102,136,0.428571,0.571429,238
7580,1,4,0.200000,0.800000,5
7582,125,41,0.753012,0.246988,166
7583,0,7,0.000000,1.000000,7
7585,379,352,0.518468,0.481532,731
7588,1,0,1.000000,0.000000,1
7589,12,10,0.545455,0.454545,22
7591,66,50,0.568966,0.431034,116
7593,193,87,0.689286,0.310714,280
7595,1,0,1.000000,0.000000,1
7600,383,132,0.743689,0.256311,515
7602,21,10,0.677419,0.322581,31
7604,41,38,0.518987,0.481013,79
7613,48,36,0.571429,0.428571,84
7614,21,9,0.700000,0.300000,30
7615,17,4,0.809524,0.190476,21
7617,2,66,0.029412,0.970588,68
7618,1,1,0.500000,0.500000,2
7620,0,1,0.000000,1.000000,1
7624,1,1,0.500000,0.500000,2
7625,41,7,0.854167,0.145833,48
7627,2,0,1.000000,0.000000,2
7629,832,316,0.724739,0.275261,1148
7631,49,2,0.960784,0.039216,51
7641,126,104,0.547826,0.452174,230
7642,2,0,1.000000,0.000000,2
7652,4,0,1.000000,0.000000,4
7653,3,4,0.428571,0.571429,7
7658,1,0,1.000000,0.000000,1
7660,0,3,0.000000,1.000000,3
7661,6,11,0.352941,0.647059,17
7662,13,5,0.722222,0.277778,18
7664,54,21,0.720000,0.280000,75
7665,8,6,0.571429,0.428571,14
7669,0,4,0.000000,1.000000,4
7676,10,8,0.555556,0.444444,18
7677,27,12,0.692308,0.307692,39
7679,4,3,0.571429,0.428571,7
7680,252,245,0.507042,0.492958,497
7687,13,28,0.317073,0.682927,41
7689,41,25,0.621212,0.378788,66
7690,2,0,1.000000,0.000000,2
7693,62,135,0.314721,0.685279,197
7699,59,16,0.786667,0.213333,75
7700,396,201,0.663317,0.336683,597
7701,20,8,0.714286,0.285714,28
7703,44,34,0.564103,0.435897,78
7706,13,0,1.000000,0.000000,13
7708,94,54,0.635135,0.364865,148
7710,216,103,0.677116,0.322884,319
7711,729,264,0.734139,0.265861,993
7712,4,10,0.285714,0.714286,14
7714,104,110,0.485981,0.514019,214
7715,10,28,0.263158,0.736842,38
7718,13,35,0.270833,0.729167,48
7724,1,1,0.500000,0.500000,2
7725,766,270,0.739382,0.260618,1036
7727,10,35,0.222222,0.777778,45
7729,41,9,0.820000,0.180000,50
7730,486,258,0.653226,0.346774,744
7731,2,2,0.500000,0.500000,4
7732,145,74,0.662100,0.337900,219
7737,58,15,0.794521,0.205479,73
7740,7,6,0.538462,0.461538,13
7745,62,77,0.446043,0.553957,139
7746,21,18,0.538462,0.461538,39
7750,4,1,0.800000,0.200000,5
7751,6,5,0.545455,0.454545,11
7752,1,12,0.076923,0.923077,13
7753,39,2,0.951220,0.048780,41
7758,43,23,0.651515,0.348485,66
7761,330,296,0.527157,0.472843,626
7763,374,306,0.550000,0.450000,680
7764,50,39,0.561798,0.438202,89
7767,1,0,1.000000,0.000000,1
7769,62,30,0.673913,0.326087,92
7770,128,61,0.677249,0.322751,189
7774,66,70,0.485294,0.514706,136
7780,25,18,0.581395,0.418605,43
7781,25,53,0.320513,0.679487,78
9489,2,5,0.285714,0.714286,7
7787,34,19,0.641509,0.358491,53
7789,96,26,0.786885,0.213115,122
7794,26,29,0.472727,0.527273,55
7799,4,8,0.333333,0.666667,12
7800,2,4,0.333333,0.666667,6
7802,29,49,0.371795,0.628205,78
7803,49,2,0.960784,0.039216,51
7805,1,3,0.250000,0.750000,4
7806,169,42,0.800948,0.199052,211
7808,125,70,0.641026,0.358974,195
7812,97,95,0.505208,0.494792,192
7815,4,2,0.666667,0.333333,6
7817,17,4,0.809524,0.190476,21
7821,1067,1224,0.465735,0.534265,2291
7822,145,93,0.609244,0.390756,238
7823,118,125,0.485597,0.514403,243
7825,1,0,1.000000,0.000000,1
7827,1,0,1.000000,0.000000,1
7833,1,2,0.333333,0.666667,3
7838,7,18,0.280000,0.720000,25
7839,1,0,1.000000,0.000000,1
7847,29,29,0.500000,0.500000,58
7848,2,0,1.000000,0.000000,2
7850,17,22,0.435897,0.564103,39
7856,4,2,0.666667,0.333333,6
7858,42,31,0.575342,0.424658,73
7869,1,0,1.000000,0.000000,1
7872,252,117,0.682927,0.317073,369
7874,2,1,0.666667,0.333333,3
7878,1,1,0.500000,0.500000,2
7882,100,213,0.319489,0.680511,313
7884,114,139,0.450593,0.549407,253
7886,2,2,0.500000,0.500000,4
7888,17,2,0.894737,0.105263,19
7889,0,1,0.000000,1.000000,1
7890,8,27,0.228571,0.771429,35
7892,1,13,0.071429,0.928571,14
7895,2,0,1.000000,0.000000,2
7896,36,21,0.631579,0.368421,57
7899,29,2,0.935484,0.064516,31
7902,11,3,0.785714,0.214286,14
7905,2,0,1.000000,0.000000,2
7906,3,1,0.750000,0.250000,4
7909,4,7,0.363636,0.636364,11
7913,2,0,1.000000,0.000000,2
7915,2,6,0.250000,0.750000,8
7916,1,2,0.333333,0.666667,3
7917,2,5,0.285714,0.714286,7
7918,2,0,1.000000,0.000000,2
7923,395,156,0.716878,0.283122,551
7924,15,22,0.405405,0.594595,37
7926,1,0,1.000000,0.000000,1
7929,2,3,0.400000,0.600000,5
7930,85,7,0.923913,0.076087,92
7933,1,0,1.000000,0.000000,1
7934,3,12,0.200000,0.800000,15
7939,113,90,0.556650,0.443350,203
7946,1,19,0.050000,0.950000,20
7948,106,48,0.688312,0.311688,154
7952,1,2,0.333333,0.666667,3
7956,2,1,0.666667,0.333333,3
7958,106,73,0.592179,0.407821,179
7962,80,57,0.583942,0.416058,137
7963,2,2,0.500000,0.500000,4
7968,1,4,0.200000,0.800000,5
7972,1,16,0.058824,0.941176,17
7973,63,30,0.677419,0.322581,93
7974,1,0,1.000000,0.000000,1
7975,12,5,0.705882,0.294118,17
7976,56,25,0.691358,0.308642,81
7980,4,2,0.666667,0.333333,6
7987,46,14,0.766667,0.233333,60
7991,1,2,0.333333,0.666667,3
7992,24,51,0.320000,0.680000,75
7993,2,10,0.166667,0.833333,12
7996,148,96,0.606557,0.393443,244
8000,8,3,0.727273,0.272727,11
8001,27,7,0.794118,0.205882,34
8002,3,4,0.428571,0.571429,7
8003,93,69,0.574074,0.425926,162
8004,36,10,0.782609,0.217391,46
8005,65,30,0.684211,0.315789,95
8013,6,1,0.857143,0.142857,7
8021,46,70,0.396552,0.603448,116
8023,1,3,0.250000,0.750000,4
8026,6,2,0.750000,0.250000,8
8027,225,187,0.546117,0.453883,412
8034,3,12,0.200000,0.800000,15
8037,0,1,0.000000,1.000000,1
8040,433,165,0.724080,0.275920,598
8041,148,130,0.532374,0.467626,278
8042,163,54,0.751152,0.248848,217
8047,22,8,0.733333,0.266667,30
8049,6,5,0.545455,0.454545,11
8052,38,7,0.844444,0.155556,45
8053,185,146,0.558912,0.441088,331
8054,9,0,1.000000,0.000000,9
8056,5,2,0.714286,0.285714,7
8067,0,1,0.000000,1.000000,1
8072,21,7,0.750000,0.250000,28
8074,0,1,0.000000,1.000000,1
8079,1,0,1.000000,0.000000,1
8083,129,102,0.558442,0.441558,231
8084,11,12,0.478261,0.521739,23
8085,38,29,0.567164,0.432836,67
8090,306,239,0.561468,0.438532,545
8091,349,217,0.616608,0.383392,566
8092,45,61,0.424528,0.575472,106
8093,2,5,0.285714,0.714286,7
8094,52,15,0.776119,0.223881,67
8099,96,24,0.800000,0.200000,120
8101,13,4,0.764706,0.235294,17
8103,3,2,0.600000,0.400000,5
8106,574,343,0.625954,0.374046,917
8107,1,9,0.100000,0.900000,10
8110,0,2,0.000000,1.000000,2
8112,6,1,0.857143,0.142857,7
8116,11,5,0.687500,0.312500,16
8119,32,7,0.820513,0.179487,39
8122,77,85,0.475309,0.524691,162
8124,68,59,0.535433,0.464567,127
8125,324,493,0.396573,0.603427,817
8127,194,93,0.675958,0.324042,287
8128,1,0,1.000000,0.000000,1
8129,5,2,0.714286,0.285714,7
8130,17,9,0.653846,0.346154,26
8136,49,12,0.803279,0.196721,61
8142,2,7,0.222222,0.777778,9
8149,0,1,0.000000,1.000000,1
8151,3,21,0.125000,0.875000,24
8153,12,18,0.400000,0.600000,30
8155,8,5,0.615385,0.384615,13
8158,27,16,0.627907,0.372093,43
8161,6,2,0.750000,0.250000,8
8163,57,36,0.612903,0.387097,93
8172,5,14,0.263158,0.736842,19
8174,18,11,0.620690,0.379310,29
8175,11,1,0.916667,0.083333,12
8176,11,20,0.354839,0.645161,31
8177,1,2,0.333333,0.666667,3
8180,2,3,0.400000,0.600000,5
8188,91,115,0.441748,0.558252,206
8190,33,5,0.868421,0.131579,38
